state,code,institution,state_full,cares_act,omnibus,amer_rescue_act,total_relief,endowment
AZ,00108100,Arizona State University,Arizona,63533137,112906424,197920000,374359561,922000000
FL,00150600,Miami Dade College,Florida,49074737,100313671,175095000,324483408,486000000
FL,00395400,University Of Central Florida,Florida,51071250,88785992,155326000,295183242,162000000
PA,00332900,Pennsylvania State University (The),Pennsylvania,54994846,84967674,149782000,289744520,4000000000
NJ,00262900,"Rutgers, The State University Of New Jersey",New Jersey,54160640,83956947,147525000,285642587,1476000000
IN,00991700,Ivy Tech Community College Of Indiana,Indiana,33040571,87521884,154176000,274738455,0
GA,00157400,Georgia State University,Georgia,45243852,81991625,143227000,270462477,0
CA,00115300,"California State University, Northridge",California,44652328,74004088,128804000,247460416,119000000
FL,00963500,Florida International University,Florida,38301957,70899027,124068000,233268984,218700000
CA,00113700,"California State University, Fullerton",California,41021512,67736949,118108000,226866461,81700000
CA,00113900,"California State University, Long Beach",California,41729439,67421424,117424000,226574863,79400000
OH,00309000,Ohio State University (The),Ohio,42885215,65158493,115136000,223179708,5290000000
TX,00363200,Texas A&M University,Texas,39816443,61084220,108020000,208920663,13514528000
CA,00114000,"California State University, Los Angeles",California,37914166,61905561,107504000,207323727,46200000
TX,00365200,University Of Houston,Texas,36703283,61804527,108166000,206673810,960000000
TX,01063300,Houston Community College,Texas,28294391,64722987,113378000,206395378,10200000
WA,00379800,University Of Washington - Seattle,Washington,39715956,59684404,105672000,205072360,6000000000
TX,01114500,Lone Star College System,Texas,28823255,63217876,111568000,203609131,0
CA,00115000,California State University - Sacramento,California,35734362,59891260,104257000,199882622,51200000
FL,00153700,University Of South Florida,Florida,34839748,58187541,102066000,195093289,532000000
TX,00359900,University Of Texas - Rio Grande Valley,Texas,34334258,58007276,100923000,193264534,46130000
FL,00675000,Valencia College,Florida,27682203,59512739,104037000,191231942,72500000
FL,00150000,Broward College,Florida,27154901,58986552,103056000,189197453,62200000
CA,00131400,"University Of California, Irvine",California,36731629,54737221,95771000,187239850,1030000000
CA,00131500,"University Of California, Los Angeles",California,35906870,52623807,92570000,181100677,5390000000
CA,00131700,"University Of California, San Diego",California,34889769,52015747,91170000,178075516,2300000000
NY,00269100,Cuny Borough Of Manhattan Community College,New York,26420828,55218492,95999000,177638320,0
CA,00114700,"California State University, Fresno",California,32802107,52725317,91631000,177158424,0
CA,00131300,"University Of California, Davis",California,33871763,51521569,90298000,175691332,1660000000
TX,00361500,Texas State University,Texas,31791509,52142552,91252000,175186061,95400000
UT,00367000,Brigham Young University,Utah,32272986,50333740,88121000,170727726,1970000000
FL,00153500,University Of Florida,Florida,31046411,49578739,87513000,168138150,1850000000
TX,01011500,University Of Texas At San Antonio,Texas,29656887,49567034,86529000,165752921,172000000
TX,00365800,University Of Texas At Austin,Texas,31462321,48376958,85475000,165314279,30100000000
CA,00114400,"California State Polytechnic University, Pomona",California,30904089,48614353,84673000,164191442,101599000
AZ,00108300,University Of Arizona,Arizona,30953447,47971859,84385000,163310306,1038133000
TX,00359400,University Of North Texas,Texas,29018088,47854595,83851000,160723683,210624000
TX,00362600,Tarrant County College District,Texas,21984486,49701915,87484000,159170401,0
CA,00115400,San Francisco State University,California,28725948,47404409,82743000,158873357,137080000
IL,00177600,University Of Illinois at Chicago,Illinois,29874590,47074555,81725000,158674145,2353000000
CA,00131600,"University Of California, Riverside",California,29734626,46440300,80888000,157062926,259800000
CA,00115500,San Jose State University,California,28769546,46631939,81613000,157014485,153212000
MI,00229000,Michigan State University,Michigan,29836588,45964753,80773000,156574341,3033279000
GA,00157700,Kennesaw State University,Georgia,27911927,46559603,81512000,155983530,40300000
CA,00131200,"University Of California, Berkeley",California,30440627,45429825,80102000,155972452,0
CA,00115100,San Diego State University,California,29394934,45914127,80465000,155774061,353334000
IL,00177500,University Of Illinois at Urbana-Champaign,Illinois,31448178,44619241,79046000,155113419,2353000000
FL,00148900,Florida State University,Florida,29339828,45382413,79899000,154621241,704106000
PA,00337100,Temple University,Pennsylvania,28740378,44242362,77788000,150770740,644089000
UT,00402700,Utah Valley University,Utah,22949207,45611519,79919000,148479726,34800000
TX,00366100,University Of Texas At El Paso,Texas,24827599,43769137,76258000,144854736,241700000
CA,00114200,"California State University, San Bernardino",California,26243781,42438131,73768000,142449912,44900000
VA,00372700,Northern Virginia Community College,Virginia,20028703,44142743,77919000,142090446,0
MN,00396900,University Of Minnesota,Minnesota,25794123,40211125,71645000,137650248,3951464000
TX,03103400,South Texas College,Texas,20022398,42189602,73775000,135987000,0
TX,00364400,Texas Tech University,Texas,25515252,39788865,69984000,135288117,1316660000
FL,02151900,Keiser University,Florida,21190626,41666816,71133000,133990442,0
NC,00297500,University Of North Carolina at Charlotte,North Carolina,24310557,39537542,69257000,133105099,230352000
OH,00312500,University Of Cincinnati,Ohio,23527312,39288631,69416000,132231943,1453000000
FL,00148100,Florida Atlantic University,Florida,22429874,39909756,69874000,132213630,227520000
FL,00151200,Palm Beach State College,Florida,18933435,40897446,71541000,131371881,0
NV,00256900,University Of Nevada,Nevada,23685293,38673077,67843000,130201370,377446000
CA,00132000,"University Of California, Santa Barbara",California,25204196,38078709,66653000,129935905,403000000
NY,00278500,New York University,New York,25626944,37413437,66798000,129838381,4345608000
PR,01171900,Universidad Ana G. Méndez - Gurabo Campus,Puerto Rico,21074293,37352341,70523000,128949634,263000000
TX,00365600,University Of Texas At Arlington,Texas,21177188,38549079,67807000,127533267,159000000
AZ,00108200,Northern Arizona University,Arizona,23577854,37511826,65713000,126802680,192621000
MI,00232500,University Of Michigan,Michigan,25244052,36174408,64414000,125832460,12448817000
IN,00180900,Indiana University ,Indiana,24572922,35998136,63810000,124381058,2486037000
NY,00283700,State University Of New York At Buffalo,New York,23952900,36082991,63486000,123521891,794000000
GA,00157200,Georgia Southern University,Georgia,22748221,36537745,63946000,123231966,56324000
GA,00159800,University Of Georgia,Georgia,23704129,35659597,63171000,122534726,1343987000
VA,00374900,George Mason University,Virginia,20855024,36198204,63918000,120971228,113199000
OH,00305100,Kent State University,Ohio,19307244,36699722,64739000,120745966,141403000
VA,02053000,Liberty University,Virginia,15205124,37777577,66300000,119282701,1587919000
ID,00162500,Brigham Young University Idaho,Idaho,18172623,36367051,63904000,118443674,103000000
WA,00380000,Washington State University,Washington,21768544,34967964,61437000,118173508,1067842000
TX,01038700,El Paso Community College,Texas,16590145,36278737,63448000,116316882,0
IN,00182500,Purdue University,Indiana,22588795,33443017,59507000,115538812,2625278000
IN,00181300,Indiana University - Purdue University Indianapolis,Indiana,20919345,33894635,59581000,114394980,691300000
MD,00210300,"University Of Maryland, College Park",Maryland,21490713,32838845,58245000,112574558,1436000000
FL,00787000,Hillsborough Community College,Florida,16262267,34912041,61096000,112270308,7219000
CA,00124500,Mount San Antonio College,California,17457959,34267707,60168000,111893666,0
IA,00186900,Iowa State University Of Science and Technology,Iowa,21698857,32442265,57329000,111470122,1101709000
NY,00268900,Cuny Hunter College,New York,19006958,33557126,58696000,111260084,136000000
CT,00141700,University Of Connecticut,Connecticut,21500845,32098504,56616000,110215349,462375000
MI,00232900,Wayne State University,Michigan,19306183,32377451,56885000,108568634,394509000
VA,00373500,Virginia Commonwealth University,Virginia,20288998,31937228,56234000,108460226,2042520000
SC,00344800,University Of South Carolina,South Carolina,21415130,31224416,55306000,107945546,788261000
AL,00105100,University Of Alabama,Alabama,20722538,31436739,55688000,107847277,1519595000
NJ,00261700,Montclair State University,New Jersey,19911482,31667908,55356000,106935390,79490000
CA,00114600,"California State University, Chico",California,19959391,31603856,55070000,106633247,62900000
NV,01036200,College Of Southern Nevada,Nevada,14078408,33500005,58831000,106409413,6160000
PA,00337900,University Of Pittsburgh,Pennsylvania,21265340,30614591,54308000,106187931,4311387000
CA,00114100,"California State University, Dominguez Hills",California,18481277,31843563,55383000,105707840,12543000
NH,00258000,Southern New Hampshire University,New Hampshire,5494008,36406842,63789000,105689850,16700000
TX,01201500,Austin Community College,Texas,13907800,32959121,58237000,105103921,0
WV,00382700,West Virginia University,West Virginia,20174232,30727088,54131000,105032320,611300000
PR,00394400,University Of Puerto Rico - Mayaguez,Puerto Rico,19658125,31050892,53894000,104603017,256000000
UT,00367500,University Of Utah,Utah,18725330,30775179,54368000,103868509,1225045000
NY,00283800,State University Of New York At Stony Brook,New York,19710714,30468755,53591000,103770469,265000000
TX,00974100,University Of Texas At Dallas,Texas,19132188,30612137,53908000,103652325,603000000
NC,00292300,East Carolina University,North Carolina,19358758,30548181,53586000,103492939,212566000
PA,00324900,Community College Of Philadelphia,Pennsylvania,16102431,31849546,55421000,103372977,0
NY,00268700,Cuny Brooklyn College,New York,17627330,31206205,54429000,103262535,86100000
FL,00148400,Florida State College At Jacksonville,Florida,14500515,32230437,56479000,103209952,41000000
NM,00266300,University Of New Mexico,New Mexico,17266512,31124648,54682000,103073160,457313000
WI,00389500,University Of Wisconsin,Wisconsin,19783001,29783409,53184000,102750410,3152578000
CA,00132800,University Of Southern California,California,19278560,29961264,53492000,102731824,5732101000
UT,00367700,Utah State University,Utah,17428745,30735450,53875000,102039195,402862000
OH,00310000,Ohio University,Ohio,19475431,29578885,52303000,101357316,580657000
NC,00297600,University Of North Carolina Greensboro,North Carolina,18567881,30132331,52590000,101290212,310300000
OR,00321600,Portland State University,Oregon,16640405,30740104,53908000,101288509,80341000
NY,00269600,New York City College Of Technology Of The City University Of New York,New York,16209328,30860066,53731000,100800394,12000000
TN,00353000,University Of Tennessee,Tennessee,19258313,29330189,51731000,100319502,1354756000
PR,02587500,Universidad Ana G. Méndez - Cupey Campus,Puerto Rico,17052692,29487643,53314000,99854335,263000000
LA,00201000,Louisiana State University Agricultural & Mechanical College,Louisiana,18882288,29264189,51689000,99835477,521800000
CA,00132100,"University Of California, Santa Cruz",California,19327201,28784842,50385000,98497043,215400000
CO,00137000,University Of Colorado,Colorado,18732408,28660299,50917000,98309707,1452722000
MI,00226800,Grand Valley State University,Michigan,18333428,28990835,50943000,98267263,132091000
CA,00126100,Pasadena City College,California,15230050,30076671,52854000,98160721,0
NY,00269000,Cuny Queens College,New York,16736798,29491179,51556000,97783977,85000000
CA,00121900,Long Beach City College,California,14663058,30001059,52555000,97219117,15000000
TN,00351000,Middle Tennessee State University,Tennessee,17299411,28959281,50677000,96935692,105575000
VA,00375400,Virginia Tech,Virginia,19398987,27790518,49426000,96615505,1357969000
TX,00360600,Sam Houston State University,Texas,17468204,28732181,50220000,96420385,116921000
MA,00222100,University Of Massachusetts - Amherst,Massachusetts,18335243,28151583,49744000,96230826,0
CO,00135000,Colorado State University,Colorado,17693711,28296524,50028000,96018235,376063000
NC,00297200,NC State University,North Carolina,17895881,28156562,49914000,95966443,1400655000
WI,00389600,University Of Wisconsin - Milwaukee,Wisconsin,16925665,28243310,50220000,95388975,0
OK,00318400,University Of Oklahoma,Oklahoma,17935530,27880322,49305000,95120852,1736000000
OR,00321300,Portland Community College,Oregon,12538743,29787645,52676000,95002388,0
NY,00727300,Cuny Bernard M. Baruch College,New York,16563226,28496963,49783000,94843189,220000000
MD,00209900,Towson University,Maryland,17335851,27802351,48800000,93938202,83500000
NM,00265700,New Mexico State University,New Mexico,14076359,27692217,51955000,93723576,182676000
MS,00242300,Mississippi State University,Mississippi,17856107,27549415,48318000,93723522,528679000
PR,00710800,University Of Puerto Rico - Rio Piedras Campus,Puerto Rico,16873620,27909114,48778000,93560734,127000000
FL,00152800,St. Petersburg College,Florida,12813482,29077189,50850000,92740671,57400000
KY,00198900,University Of Kentucky,Kentucky,17811058,26729420,47204000,91744478,1407221000
OH,00686700,Columbus State Community College,Ohio,12562800,28667248,50509000,91739048,0
CA,00111800,Bakersfield College,California,12182994,28817459,50541000,91541453,0
NY,00269300,Cuny John Jay College Of Criminal Justice,New York,15320009,27635844,48174000,91129853,0
TN,00350900,University of Memphis,Tennessee,15603749,27375611,47862000,90841360,220800000
NY,00268800,City College Of New York - Cuny,New York,15399906,27101618,47252000,89753524,264000000
OR,00321000,Oregon State University,Oregon,15559998,26602486,46974000,89136484,622473000
NY,01005100,Cuny Laguardia Community College,New York,12917232,27737337,48436000,89090569,6200000
OK,00317000,Oklahoma State University,Oklahoma,16765725,26166701,46027000,88959426,0
CA,03011300,"California State University, San Marcos",California,15963036,26602684,46376000,88941720,27900000
VA,00372800,Old Dominion University,Virginia,15548901,26643627,46649000,88841528,261711000
NC,00297400,University Of North Carolina at Chapel Hill,North Carolina,17295177,25474540,45165000,87934717,3671351000
CA,02226000,East Los Angeles College,California,10797043,27863000,49235000,87895043,0
PR,00394100,Universidad Ana G. Méndez - Carolina Campus,Puerto Rico,14212207,25568181,47479000,87259388,0
CO,00136000,Metropolitan State University Of Denver,Colorado,14390083,26366088,46146000,86902171,0
IA,00189200,University Of Iowa,Iowa,16171354,24985012,44971000,86127366,1578933000
CA,00116300,Chaffey Community College,California,11446484,27096162,47539000,86081646,0
NY,00283500,State University Of New York At Albany,New York,16063982,25189865,44087000,85340847,77700000
IL,00169200,Illinois State University,Illinois,16121422,24967651,43834000,84923073,144435000
CA,00130700,Fresno City College,California,11224898,26689998,46894000,84808896,0
VA,00371200,Tidewater Community College,Virginia,11999956,26394906,46174000,84568862,0
MO,00251600,University Of Missouri,Missouri,16309144,24612553,43572000,84493697,1743142000
NY,00702200,Cuny Lehman College,New York,13293096,25866919,45102000,84262015,0
MI,00233000,Western Michigan University,Michigan,15486304,24878439,43702000,84066743,404653000
NY,00287800,Suffolk County Community College,New York,13179539,25567624,44966000,83713163,0
CA,00116100,Cerritos Community College,California,12186449,25937610,45394000,83518059,0
CA,00123200,American River College,California,10613663,26247243,46362000,83222906,0
OR,00322300,University Of Oregon,Oregon,16095946,24150869,42587000,82833815,912000000
LA,00462500,Delgado Community College,Louisiana,11310381,26068215,45345000,82723596,0
NC,00290600,Appalachian State University,North Carolina,15927932,24036104,42174000,82138036,122400000
NE,00256500,University Of Nebraska,Nebraska,15628700,23871084,42162000,81661784,1435753000
AR,00110800,University Of Arkansas,Arkansas,15454361,23908298,42289000,81651659,1221935000
CA,00113800,"California State University, East Bay",California,14617347,24243652,42317000,81177999,0
CA,00119700,El Camino College,California,11659979,25121457,44176000,80957436,0
CA,00128600,Santa Monica College,California,12193513,24643186,43542000,80378699,0
IL,00173700,Northern Illinois University,Illinois,14825179,23728409,41518000,80071588,80065000
MA,00213000,Boston University,Massachusetts,14995316,23192730,41556000,79744046,2304235000
MS,00244000,University Of Mississippi,Mississippi,16642638,22812460,40263000,79718098,736288000
GA,04142900,Georgia Gwinnett College,Georgia,13470330,24155260,42048000,79673590,0
AL,00100900,Auburn University,Alabama,15645745,23036339,40966000,79648084,792983000
GA,00158500,University Of North Georgia,Georgia,13636481,23881394,41865000,79382875,55600000
KS,00194800,Kansas University,Kansas,15189645,23072146,40884000,79145791,1816931000
CA,00127000,Riverside City College,California,10831532,24611165,43151000,78593697,0
MO,00250300,Missouri State University,Missouri,13855674,23441360,41239000,78536034,145800000
NJ,00260900,Rowan University,New Jersey,14471695,23165569,40676000,78313264,232094000
UT,00368000,Weber State University,Utah,11714226,24098981,42489000,78302207,150522000
MI,00225900,Eastern Michigan University,Michigan,13733990,23256060,40832000,77822050,78171000
IN,00178600,Ball State University,Indiana,15246930,22465635,39765000,77477565,212834000
UT,00522000,Salt Lake Community College,Utah,10647873,24130769,42580000,77358642,0
OH,00312300,University Of Akron,Ohio,14151817,22879071,40198000,77228888,235962000
IL,00167100,Depaul University,Illinois,14373219,22684440,39976000,77033659,696452000
TX,02361400,Collin County Community College,Texas,10790912,23826101,42319000,76936013,0
MI,00224300,Central Michigan University,Michigan,14322194,22642806,39780000,76745000,189322000
NC,00290500,North Carolina Agricultural & Technical State University,North Carolina,14103628,22848969,39774000,76726597,73800000
NY,00269700,Queensborough Community College-Cuny,New York,11321080,23701583,41362000,76384663,0
NJ,00262200,Kean University,New Jersey,13509139,22855391,39893000,76257530,0
NV,00256800,"University Of Nevada , Reno",Nevada,14244534,22437606,39517000,76199140,367500000
CA,00799300,"California State University, Bakersfield",California,13588942,22855632,39754000,76198574,25474000
MI,00230700,Oakland University,Michigan,13796824,22347727,39264000,75408551,99399000
TX,00360900,San Jacinto Community College District,Texas,8950463,23826057,42022000,74798520,0
MD,00691100,Montgomery College,Maryland,10995749,23080761,40556000,74632510,0
PA,00325600,Drexel University,Pennsylvania,13179268,21945057,39438000,74562325,813685000
NY,00269800,College Of Staten Island/Cuny,New York,12595956,22565946,39350000,74511902,0
OH,00304000,Cuyahoga Community College,Ohio,10027370,23257012,40795000,74079382,0
CA,00115700,"California State University, Stanislaus",California,13314715,22007207,38261000,73582922,0
RI,00340400,Johnson & Wales University,Rhode Island,14182680,21525278,37558000,73265958,0
TX,00363000,Prairie View Agricultural & Mechanical University,Texas,13752928,21681605,37676000,73110533,0
OH,00313100,University Of Toledo,Ohio,13547254,21572302,37917000,73036556,454114000
TX,03026500,Remington College,Texas,13408868,21585012,37725000,72718880,0
MS,00244100,University Of Southern Mississippi,Mississippi,13506042,21475374,37492000,72473416,104878000
AZ,00726600,Pima County Community College,Arizona,9989049,22597292,39694000,72280341,0
NY,00287300,Nassau Community College,New York,12022119,21854649,38330000,72206768,0
NC,00291500,Central Piedmont Community College,North Carolina,10787553,22154356,38852000,71793909,0
CA,00114300,California Polytechnic State University,California,14095976,20752799,36681000,71529775,227700000
OH,00301800,Bowling Green State University,Ohio,13163417,21124710,37162000,71450127,149438000
MA,00222200,University Of Massachusetts - Boston,Massachusetts,12184652,21381281,37440000,71005933,0
NY,00269400,Kingsborough Commmunity College/Cuny,New York,10156521,22157742,38688000,71002263,0
NC,00484400,Wake Technical Community College,North Carolina,10390849,21750983,38154000,70295832,0
RI,00340800,Community College Of Rhode Island,Rhode Island,10000569,21958065,38309000,70267634,0
FL,00148000,Florida Agricultural & Mechanical University,Florida,13051325,20845563,36273000,70169888,95600000
PR,00393600,Pontifical Catholic University Of Puerto Rico (The),Puerto Rico,12669949,20974546,36417000,70061495,0
SC,00342500,Clemson University,South Carolina,13579995,20323247,36093000,69996242,774514000
NY,00283600,Binghamton University,New York,13607332,20273531,35679000,69559863,0
CA,00111300,Antelope Valley College,California,10245691,21580696,37647000,69473387,0
LA,00203100,University Of Louisiana At Lafayette,Louisiana,12686007,20614028,36119000,69419035,153000000
NY,00269200,Cuny Bronx Community College,New York,9658626,21655807,37641000,68955433,0
KY,00199900,University Of Louisville,Kentucky,12478790,20434285,36008000,68921075,719816000
OH,00307700,Miami University,Ohio,12989033,19996909,35489000,68474942,560965000
NM,00474200,Central New Mexico Community College,New Mexico,9305433,21404465,37661000,68370898,0
CA,04127100,"University Of California, Merced",California,13037897,20217509,35115000,68370406,0
TX,00363400,Texas State Technical College,Texas,9965155,21292313,37108000,68365468,0
MD,00206300,Community College Of Baltimore County,Maryland,9349870,21419784,37525000,68294654,0
OH,00303200,Cleveland State University,Ohio,12226765,20280093,35553000,68059858,0
ID,00161600,Boise State University,Idaho,10937516,20644600,36458000,68040116,115056000
AL,00105200,University Of Alabama At Birmingham,Alabama,12131256,20190148,35527000,67848404,537300000
NY,00282300,Saint John'S University,New York,12191880,20127659,35491000,67810539,0
PA,00327300,Harrisburg Area Community College,Pennsylvania,9105781,21319018,37300000,67724799,0
KS,00192800,Kansas State University,Kansas,12686554,19845018,35036000,67567572,510300000
TX,00354900,Blinn College,Texas,14141911,19342202,33875000,67359113,0
MI,00890600,Macomb Community College,Michigan,9617297,20872067,36647000,67136364,0
FL,00984100,University Of North Florida,Florida,11770196,20011442,35124000,66905638,116186000
CA,00124000,Modesto Junior College,California,9575504,20615809,36120000,66311313,0
IL,00665600,College Of Du Page,Illinois,9100886,20581172,36504000,66186058,0
CA,00120100,Fullerton College,California,9700734,20180789,35604000,65485523,0
WI,00386600,Milwaukee Area Technical College,Wisconsin,8505373,20700673,36160000,65366046,0
TX,00364200,Texas Southern University,Texas,11796898,19514520,33957000,65268418,59400000
MS,00240700,Hinds Community College,Mississippi,10520779,19910506,34710000,65141285,0
CA,00124600,Mt. San Jacinto College,California,9713109,20043399,35128000,64884508,0
NY,00271100,Cornell University,New York,12800980,18512730,33049000,64362710,7328241000
OK,00315200,University Of Central Oklahoma,Oklahoma,11170390,19306609,33801000,64277999,0
MA,00219900,Northeastern University,Massachusetts,11648813,18744880,33705000,64098693,1055474000
NY,00270700,Columbia University In The City Of New York,New York,12830199,18314873,32952000,64097072,10950738000
NY,00287200,Monroe Community College,New York,9166962,19927127,34921000,64015089,0
FL,00149300,Indian River State College,Florida,9553094,19691247,34501000,63745341,0
CA,00129400,Southwestern Community College District,California,9253264,19762638,34712000,63727902,0
CO,00450800,University Of Colorado Denver,Colorado,10184083,19226923,34108000,63519006,593000000
PA,00332800,West Chester University Of Pennsylvania,Pennsylvania,11992115,18645808,32820000,63457923,0
MO,00247100,Saint Louis Community College,Missouri,8727263,19785083,34748000,63260346,0
LA,00202400,Southeastern Louisiana University,Louisiana,10580284,18997836,33266000,62844120,0
CA,00120300,Glendale Community College,California,10056959,19042328,33367000,62466287,0
KY,00200200,Western Kentucky University,Kentucky,10636493,18748413,32954000,62338906,175186000
FL,03255300,Florida Gulf Coast University,Florida,11143620,18572907,32567000,62283527,84600000
DE,00143100,University Of Delaware,Delaware,12174809,18010638,32080000,62265447,1466070000
MI,00227000,Henry Ford College,Michigan,9153117,19312149,33712000,62177266,0
FL,00147700,Florida Southwestern State College,Florida,9178997,19237570,33689000,62105567,0
CA,00123300,Sacramento City College,California,7946038,19563511,34491000,62000549,0
GA,00160100,University Of West Georgia,Georgia,10881459,18585785,32491000,61958244,0
WA,00380200,Western Washington University,Washington,11641693,18228534,31969000,61839227,77349000
VA,00372100,James Madison University,Virginia,12080658,17880192,31758000,61718850,111065000
AL,00105700,University Of South Alabama,Alabama,11408535,18170202,31876000,61454737,383512000
DE,01172700,Delaware Technical Community College,Delaware,9008399,19085686,33348000,61442085,0
KY,00196300,Eastern Kentucky University,Kentucky,10542767,18411187,32230000,61183954,69139000
AZ,00107600,Glendale Community College,Arizona,8301836,19156542,33641000,61099378,0
TX,00363100,Tarleton State University,Texas,10893519,18126764,31698000,60718283,0
MO,00248400,Metropolitan Community College,Missouri,8709049,18839455,33027000,60575504,0
TN,00348700,East Tennessee State University,Tennessee,11096758,17943833,31435000,60475591,0
NE,00255400,University Of Nebraska At Omaha,Nebraska,10759273,18001689,31576000,60336962,71600000
TN,00347800,Austin Peay State University,Tennessee,9687866,18455648,32177000,60320514,0
HI,00161000,University Of Hawaii At Manoa,Hawaii,11009867,17701585,31212000,59923452,327000000
RI,00341400,University Of Rhode Island,Rhode Island,11238683,17440405,30786000,59465088,149154000
TX,00361200,University Of Houston - Downtown,Texas,9456650,18182989,31758000,59397639,0
FL,00147000,Eastern Florida State College,Florida,8816361,18346823,32087000,59250184,0
CA,00125000,Orange Coast College,California,9120468,18102486,31971000,59193954,0
NH,00258900,University Of New Hampshire,New Hampshire,11647555,17118551,30232000,58998106,803867000
VA,00374500,University Of Virginia,Virginia,11716710,16866806,30229000,58812516,7058235000
OK,00976300,Tulsa Community College,Oklahoma,7980293,18390355,32212000,58582648,0
OH,00314500,Youngstown State University,Ohio,10376462,17353182,30357000,58086644,279778000
OH,00307800,Wright State University,Ohio,10140846,17372092,30558000,58070938,97080000
NY,00284200,Suny College At Buffalo,New York,10484417,17271471,30077000,57832888,0
NY,00288200,Syracuse University,New York,9920122,17139335,30741000,57800457,1392691000
OH,00311900,Sinclair Community College,Ohio,7434204,18192393,32046000,57672597,30718000
TX,00362400,Stephen F Austin State University,Texas,10525078,17133422,29973000,57631500,0
FL,00152000,Seminole State College Of Florida,Florida,8150059,17960733,31497000,57607792,0
MA,01121000,Bunker Hill Community College,Massachusetts,8310307,17939271,31347000,57596578,0
NY,00280600,Rochester Institute Of Technology,New York,10380480,17026233,29972000,57378713,944883000
NC,00298400,University Of North At Carolina Wilmington (The),North Carolina,10566053,16948600,29804000,57318653,104000000
CA,00118600,College Of The Sequoias,California,8630859,17686139,30894000,57210998,0
TX,00916300,San Antonio College,Texas,7648254,17950364,31537000,57135618,0
PA,00323100,Community College Of Allegheny County,Pennsylvania,7987479,17789944,31264000,57041423,0
AZ,00107700,Mesa Community College,Arizona,7352103,17795363,31352000,56499466,0
GA,00156900,Georgia Institute Of Technology,Georgia,10388077,16463107,29480000,56331184,2169005000
WA,00377500,Eastern Washington University,Washington,9986299,16721122,29327000,56034421,24195000
TX,00965100,Texas A&M International University,Texas,9501756,16965643,29504000,55971399,0
TX,01116100,Texas A&M University - Corpus Christi,Texas,10105662,16650317,29147000,55902979,0
MT,00253200,Montana State University,Montana,10560079,16378060,28909000,55847139,180168000
CA,00133500,Victor Valley Community College,California,8067843,17276235,30171000,55515078,0
NJ,01295400,Hudson County Community College,New Jersey,8467661,17156604,29847000,55471265,0
CA,00122600,Los Angeles Pierce College,California,7694796,17269929,30374000,55338725,0
CA,00126000,Palomar College,California,7702862,17131625,30395000,55229487,0
MO,03083000,Ozarks Technical Community College,Missouri,7950662,17034808,29731000,54716470,0
NJ,00262500,William Paterson University Of New Jersey,New Jersey,9763356,16326775,28497000,54587131,0
CA,00114900,Humboldt State University,California,10302998,16130016,28056000,54489014,30294000
NJ,00473600,Bergen Community College,New Jersey,8461418,16666659,29228000,54356077,0
TX,00354500,Baylor University,Texas,10777489,15704656,27828000,54310145,1340417000
CA,00128000,San Joaquin Delta College,California,7835430,16847806,29616000,54299236,0
IA,00712000,Des Moines Area Community College,Iowa,7345999,16915417,30001000,54262416,0
IN,00180700,Indiana State University,Indiana,9566914,16123384,28215000,53905298,67714000
MI,00226000,Ferris State University,Michigan,9146813,16169673,28320000,53636486,87355000
MD,01164400,University Of Maryland Global Campus,Maryland,5210563,17500109,30845000,53555672,0
AL,00104700,Troy University,Alabama,8544084,16265960,28482000,53292044,129192000
IL,00171000,Loyola University,Illinois,10043948,15534548,27467000,53045496,692166000
GA,00159900,Valdosta State University,Georgia,9331398,15904262,27784000,53019660,0
NE,01258600,Metropolitan Community College,Nebraska,5767395,14067027,24786000,44620422,0
CA,00129000,Sierra College,California,7595581,16340166,28802000,52737747,0
NJ,00934500,Stockton University,New Jersey,10041238,15511416,27132000,52684654,0
MI,00230300,Oakland Community College,Michigan,7474366,16298327,28758000,52530693,0
SC,00345100,Coastal Carolina University,South Carolina,10054347,15415915,26975000,52445262,51483000
IL,00175900,Southern Illinois University Edwardsville,Illinois,9678393,15509840,27230000,52418233,26568000
CO,00889600,Pikes Peak Community College,Colorado,7543778,16312451,28549000,52405229,0
FL,00147500,Daytona State College,Florida,7681731,16243172,28420000,52344903,0
PA,00327700,Indiana University Of Pennsylvania,Pennsylvania,10050461,15342227,26877000,52269688,7615000
CA,00450200,City College Of San Francisco,California,7009874,16223115,28984000,52216989,0
AR,00109000,Arkansas State University,Arkansas,9258158,15575949,27357000,52191107,0
AR,00109200,University Of Central Arkansas,Arkansas,9604924,15456600,27055000,52116524,0
TN,00352200,Tennessee State University,Tennessee,7214661,13306383,31435000,51956044,0
LA,00202500,Southern University And Agricultural & Mechanical Colg At Baton Rouge,Louisiana,9396803,15459340,26887000,51743143,0
MA,00216100,University Of Massachusetts - Lowell,Massachusetts,8900322,15481101,27285000,51666423,100000000
CA,00126900,Rio Hondo Community College,California,6232775,16317598,28860000,51410373,0
NC,00483800,Guilford Technical Community College,North Carolina,8260390,15718356,27393000,51371746,0
CO,00793300,Front Range Community College,Colorado,7046470,16023686,28248000,51318156,0
MI,00923000,Wayne County Community College District,Michigan,6158090,16399714,28688000,51245804,0
MD,00210500,University Maryland,Maryland,9315657,15200168,26720000,51235825,0
NY,00861100,"Cuny, Hostos Community College",New York,7267430,16037693,27864000,51169123,0
TN,00352900,University Of Tennessee - Chattanooga,Tennessee,9513779,15131381,26509000,51154160,0
PA,00337800,University Of Pennsylvania,Pennsylvania,9907683,14600409,26364000,50872092,14649762000
TN,01043900,Southwest Tennessee Community College,Tennessee,7298437,15887215,27671000,50856652,0
CA,00120800,Grossmont College,California,7141562,15800280,27833000,50774842,0
TX,00364600,Texas Woman'S University,Texas,8683388,15250810,26807000,50741198,79577000
FL,00153300,Tallahassee Community College,Florida,7763584,15548981,27210000,50522565,0
FL,00151900,Santa Fe College,Florida,7859449,15471315,27163000,50493764,0
CA,00128400,Santa Ana College,California,5594396,16096029,28797000,50487425,0
CA,00119300,Cypress College,California,7147934,15639532,27506000,50293466,0
TX,00358200,Laredo College,Texas,8926222,15039999,26316000,50282221,0
KS,00195000,Wichita State University,Kansas,8786465,14991432,26317000,50094897,276142000
CT,00137800,Central Connecticut State University,Connecticut,9009014,14879577,26085000,49973591,0
CA,00121400,Imperial Valley College,California,4995150,16249873,28275000,49520023,0
TX,03372300,Northwest Vista College,Texas,6926619,15424223,27149000,49499842,0
WV,00381500,Marshall University,West Virginia,9003939,14679980,25792000,49475919,140181000
MN,00236000,"Minnesota State University, Mankato",Minnesota,9088962,14617272,25760000,49466234,0
NC,00298100,Western Carolina University,North Carolina,8893407,14719306,25761000,49373713,88701000
AL,00100200,Alabama Agricultural & Mechanical University,Alabama,9121201,14519790,25215000,48855991,0
TX,00364800,Tyler Junior College,Texas,7395647,15043429,26340000,48779076,0
NJ,00261500,Middlesex County College,New Jersey,7378634,14976713,26245000,48600347,0
MS,00241700,Mississippi Gulf Coast Community College,Mississippi,7880280,14832095,25873000,48585375,0
SC,00399300,Midlands Technical College,South Carolina,7332783,15009166,26197000,48538949,9289000
NJ,00710700,Essex County College,New Jersey,7752662,14868024,25891000,48511686,0
MA,00218300,Bridgewater State University,Massachusetts,8833662,14374448,25299000,48507110,0
MD,00208300,Morgan State University,Maryland,9263592,14278129,24877000,48418721,0
NC,00295000,North Carolina Central University,North Carolina,8932233,14295567,24908000,48135800,0
MA,00215500,Harvard University,Massachusetts,8655748,13992069,25453000,48100817,39427896000
NY,00288100,Suny Westchester Community College,New York,7195672,14856758,25985000,48037430,0
NY,01068400,Erie Community College,New York,7995845,14464959,25390000,47850804,0
NJ,00264300,Union County College,New Jersey,7393008,14722903,25706000,47821911,0
CA,00116600,Citrus College,California,7429415,14643671,25731000,47804086,0
CA,03980300,California State University Channel Islands,California,8580009,14288099,24872000,47740108,16050000
DC,00144400,George Washington University,District of Columbia,9118529,13793324,24768000,47679853,1778559000
PR,00502800,Inter American University Of Puerto Rico - Bayamon Campus,Puerto Rico,8889905,14186459,24560000,47636364,0
CA,00115600,Sonoma State University,California,9093447,13980795,24453000,47527242,52281000
VA,00373200,Radford University,Virginia,9092203,14055735,24359000,47506938,56080000
MI,00226700,Grand Rapids Community College,Michigan,6806171,14722172,25851000,47379343,0
NJ,00261300,New Jersey City University,New Jersey,8337070,14225979,24790000,47353049,0
CA,00122800,Los Angeles Valley College,California,6154624,14883877,26161000,47199501,0
CO,00450900,University Of Colorado Colorado Springs,Colorado,7925645,14140787,24876000,46942432,0
CA,00118200,College Of The Desert,California,7061346,14500076,25357000,46918422,0
MD,00208900,Prince George'S Community College,Maryland,6421788,14714347,25763000,46899135,0
IL,00175800,Southern Illinois University At Carbondale,Illinois,8866635,13756851,24136000,46759486,0
CA,00448000,De Anza Community College,California,7235258,14159017,25192000,46586275,0
FL,00147900,Embry-Riddle Aeronautical University,Florida,6845716,14390767,25327000,46563483,161405000
CA,00890300,College Of The Canyons,California,6326734,14427200,25722000,46475934,0
IL,00769200,Moraine Valley Community College,Illinois,6465543,14452872,25493000,46411415,0
CA,00807300,Butte College,California,7281962,14144568,24730000,46156530,0
NJ,00262100,New Jersey Institute Of Technology,New Jersey,8110969,13798201,24200000,46109170,129455000
CA,00127200,San Bernardino Valley College,California,6732563,14257809,25044000,46034372,0
PR,04254200,Inter American University Of Puerto Rico San Germán Campus,Puerto Rico,8830671,13593393,23554000,45978064,0
TN,00352300,Tennessee Technological University,Tennessee,8713463,13533046,23687000,45933509,0
KY,00927500,Northern Kentucky University,Kentucky,7998963,13713911,24131000,45843874,105501000
CT,00140600,Southern Connecticut State University,Connecticut,8390168,13594612,23804000,45788780,30520000
MS,00241000,Jackson State University,Mississippi,8446248,13577858,23631000,45655106,0
PR,00394000,Inter American University Of Puerto Rico - Metropolitan Campus,Puerto Rico,7548666,13899227,24198000,45645893,0
NY,00475900,Cuny York College,New York,7205414,14007349,24431000,45643763,0
MN,00237700,St. Cloud State University,Minnesota,7821764,13652272,24024000,45498036,0
CA,00119100,Diablo Valley College,California,6679277,13947135,24804000,45430412,0
CA,03260300,"California State University, Monterey Bay",California,8459727,13455716,23461000,45376443,0
CA,00112500,California Baptist University,California,7913118,13577444,23756000,45246562,65618000
FL,01065200,Pasco - Hernando State College,Florida,6574907,13965491,24418000,44958398,0
WI,00392600,University Of Wisconsin - Whitewater,Wisconsin,8169773,12907818,23878000,44955591,0
LA,03730300,Baton Rouge Community College,Louisiana,6420025,14020032,24419000,44859057,0
WA,00377100,Central Washington University,Washington,7695384,13588432,23572000,44855816,0
CA,00127500,San Diego Mesa College,California,5911519,13992119,24888000,44791638,0
CA,00123700,Merced Community College,California,6536491,13763999,24120000,44420490,0
NY,01009700,Cuny Medgar Evers College,New York,7109437,13615664,23689000,44414101,0
SC,00399100,Greenville Technical College,South Carolina,6663667,13723584,23994000,44381251,0
NY,00279100,Pace University,New York,8562106,12938858,22868000,44368964,193049000
IL,00173900,Northwestern University,Illinois,8521175,12775920,22993000,44290095,11091516000
SC,00492000,Trident Technical College,South Carolina,6568275,13700146,24010000,44278421,0
IA,00407600,Kirkwood Community College,Iowa,6336610,13718324,24116000,44170934,0
GA,02141500,Savannah College Of Art And Design,Georgia,8209651,12972158,22938000,44119809,0
DC,00144800,Howard University,District of Columbia,8723244,12747281,22324000,43794525,692832000
PR,00393900,Inter American University Of Puerto Rico - Aguadilla Campus,Puerto Rico,8125496,12904606,22341000,43371102,0
CA,00122700,Los Angeles Trade-Technical College,California,5124229,13850786,24378000,43353015,0
IN,00458600,Purdue University Global,Indiana,816781,15423168,27103000,43342949,0
IL,00178000,Western Illinois University,Illinois,7997093,12857820,22455000,43309913,0
ID,00162000,Idaho State University,Idaho,7097839,13094512,23001000,43193351,0
CA,00753600,Cosumnes River College,California,5574947,13570233,23910000,43055180,0
FL,00151400,Polk State College,Florida,6116050,13292541,23258000,42666591,0
NY,00284800,Suny College At Oswego,New York,7244716,12886557,22508000,42639273,0
TX,00358100,Lamar University,Texas,7048774,12878096,22641000,42567870,26222000
MO,00251800,University Of Missouri - Kansas City,Missouri,7062723,12791149,22638000,42491872,0
CO,00134900,University Of Northern Colorado,Colorado,7650214,12601749,22205000,42456963,89775000
NC,00764000,Fayetteville Technical Community College,North Carolina,5913774,13276771,23217000,42407545,0
CA,00128700,Santa Rosa Junior College,California,5942841,13114035,23333000,42389876,0
AR,00108900,Arkansas Tech University,Arkansas,7098986,12806406,22408000,42313392,0
NY,01014200,Touro College,New York,7558879,12565306,22146000,42270185,0
TX,00356500,Texas A&M University - Commerce,Texas,7193156,12743661,22316000,42252817,0
NY,00277200,Mercy College,New York,7046720,12742981,22286000,42075701,255751000
NY,00284100,Suny College At Brockport,New York,7750148,12461885,21778000,41990033,0
MT,00253600,University Of Montana (The),Montana,7652275,12405952,21796000,41854227,0
NY,00272200,Fordham University,New York,8147184,12071949,21532000,41751133,733516000
ME,00205300,University Of Maine,Maine,7603694,12814741,21233000,41651435,227085000
CA,00122300,Los Angeles City College,California,5197272,13476393,22846000,41519665,0
PA,00719100,Northampton County Area Community College,Pennsylvania,6039116,12847473,22454000,41340589,57014000
PA,00331500,Bloomsburg University Of Pennsylvania,Pennsylvania,7906785,12137403,21259000,41303188,0
CA,00123900,Miracosta College,California,5511006,12933970,22777000,41221976,0
PR,00502900,Inter American University Of Puerto Rico - Ponce Campus,Puerto Rico,7526308,12302765,21324000,41153073,0
FL,00153600,University Of Miami,Florida,8139089,11829536,21171000,41139625,0
NY,00285800,State University Of New York At Farmingdale,New York,6154318,12645901,22339000,41139219,0
NJ,00686500,Camden County College,New Jersey,5784112,12826935,22495000,41106047,0
NJ,00840400,Brookdale Community College,New Jersey,6334411,12582654,22163000,41080065,0
LA,00200600,Grambling State University,Louisiana,7010388,12427854,21600000,41038242,0
GA,00157100,Georgia Military College,Georgia,5998679,12723116,22285000,41006795,0
IA,00189000,University Of Northern Iowa,Iowa,7618737,12078044,21259000,40955781,129019000
NY,00275100,Long Island University,New York,7007826,12239114,21670000,40916940,238973000
FL,00395500,University Of West Florida (The),Florida,6801388,12369966,21717000,40888354,0
FL,00151300,Pensacola State College,Florida,6004939,12679127,22177000,40861066,0
RI,00340700,Rhode Island College,Rhode Island,7443916,12110287,21159000,40713203,0
ND,00299700,North Dakota State University - Fargo,North Dakota,7728326,11906777,21024000,40659103,0
TX,00363900,Texas A&M University - Kingsville,Texas,7087427,12173235,21281000,40541662,0
OR,00321800,Chemeketa Community College,Oregon,5750738,12612572,22114000,40477310,0
SC,00342800,College Of Charleston,South Carolina,7642022,11866554,20905000,40413576,100136000
CO,00135800,Colorado Mesa University,Colorado,7068379,12116155,21213000,40397534,34875000
IL,00396100,Harper College,Illinois,5526516,12582067,22281000,40389583,25382000
KY,00696100,Jefferson Community And Technical College,Kentucky,5179693,12800342,22392000,40372035,0
MI,00232600,University Of Michigan - Dearborn,Michigan,6989129,12130348,21231000,40350477,0
MO,00245400,University Of Central Missouri,Missouri,6908319,12074346,21271000,40253665,0
WI,00400700,Madison Area Technical College,Wisconsin,5500069,12510691,22095000,40105760,0
NJ,00690100,Rowan College Of South Jersey,New Jersey,6557641,12793980,20637000,39988621,0
WI,00392000,University Of Wisconsin - Oshkosh,Wisconsin,6207761,11441915,22157000,39806676,0
PA,00711000,Delaware County Community College,Pennsylvania,5360154,12387247,22039000,39786401,0
OK,01039100,Oklahoma City Community College,Oklahoma,5566700,12328985,21760000,39655685,0
MO,00251900,University Of Missouri - Saint Louis,Missouri,5830225,12190644,21566000,39586869,0
IL,00169900,Joliet Junior College,Illinois,5497625,12291882,21773000,39562507,0
UT,00367100,Dixie State University,Utah,6176699,12124489,21246000,39547188,0
ID,00162600,University Of Idaho,Idaho,6905295,11786287,20753000,39444582,291868000
GA,02288400,Gwinnett Technical College,Georgia,5336576,12417270,21682000,39435846,0
GA,00156400,Emory University,Georgia,7974341,11277994,20158000,39410335,7872381000
TX,00400300,Central Texas College District,Texas,4544176,12611938,22185000,39341114,0
FL,00150900,Nova Southeastern University,Florida,7157194,11510184,20494000,39161378,0
PA,00332200,Kutztown University Of Pennsylvania,Pennsylvania,7424966,11533902,20190000,39148868,0
PR,00722800,University Of Puerto Rico - Arecibo,Puerto Rico,7684735,11195711,19382000,38262446,0
PR,00502600,Inter American University Of Puerto Rico - Arecibo Campus,Puerto Rico,7100104,11633980,20153000,38887084,0
LA,00200800,Louisiana Tech University,Louisiana,7094887,11558542,20121000,38774429,0
OH,01088100,Stark State College,Ohio,5036299,12228524,21385000,38649823,0
MO,00250100,Southeast Missouri State University,Missouri,6830214,11510345,20198000,38538559,0
PA,00332700,Slippery Rock University,Pennsylvania,7354069,11285058,19805000,38444127,0
CA,00128500,Santa Barbara City College,California,5767428,11790275,20856000,38413703,0
MN,00238800,University Of Minnesota Duluth,Minnesota,7453951,11174098,19706000,38334049,0
VA,00376500,Norfolk State University,Virginia,6901715,11451132,19898000,38250847,24435000
MI,00231400,Saginaw Valley State University,Michigan,6911064,11372114,19912000,38195178,87436000
WI,00391700,University Of Wisconsin - Eau Claire,Wisconsin,7091955,11056971,19990000,38138926,81094000
GA,00897600,Clayton State University,Georgia,6165671,11647843,20280000,38093514,0
CA,00130500,Stanford University,California,7376668,10890455,19630000,37897123,27699834000
KS,00824400,Johnson County Community College,Kansas,5080285,11797233,21010000,37887518,0
MI,00232800,Washtenaw Community College,Michigan,4968890,11902486,20985000,37856376,0
NJ,00999400,Passaic County Community College,New Jersey,5451658,11803091,20591000,37845749,0
IL,00165200,Harold Washington College,Illinois,5708949,11637196,20372000,37718145,0
MI,00227800,Lansing Community College,Michigan,5804315,11559366,20306000,37669681,0
AK,01146200,University Of Alaska Anchorage,Alaska,5445184,11625475,20584000,37654659,0
PR,01097500,University Of Puerto Rico Bayamon Technical University College,Puerto Rico,6991670,11082944,19567000,37641614,0
NY,00286600,Fashion Institute Of Technology,New York,7035399,11106697,19490000,37632096,0
CA,00127300,San Diego City College,California,4592301,11923790,21094000,37610091,0
UT,00367400,Stevens Henager College,Utah,2830028,11895706,22811000,37536734,0
GA,00158100,Middle Georgia State University,Georgia,5988167,11474878,20012000,37475045,0
MI,00467300,Baker College,Michigan,5754381,11529356,20091000,37374737,0
UT,00367800,Southern Utah University,Utah,5624696,11460963,20173000,37258659,0
GA,00156100,Columbus State University,Georgia,6352178,11232074,19633000,37217252,69502000
AZ,00107800,Phoenix College,Arizona,4772192,11740227,20595000,37107419,0
GA,00154400,Albany State University,Georgia,5137088,11661954,20281000,37080042,0
IL,00769400,College Of Lake County,Illinois,4973042,11539049,20458000,36970091,0
MI,00226100,Charles Stewart Mott Community College,Michigan,5378749,11499149,20052000,36929898,0
CA,00132500,University Of San Francisco,California,7293888,10701243,18909000,36904131,399571000
TX,00354100,Angelo State University,Texas,6359561,11037672,19375000,36772233,0
IL,00169300,Northeastern Illinois University,Illinois,6070904,11170485,19527000,36768389,0
NC,00295400,University Of North Carolina At Pembroke,North Carolina,6274710,11102045,19354000,36730755,24886000
VT,00369600,University Of Vermont And State Agricultural College,Vermont,7055880,10675412,18995000,36726292,0
GA,00576300,Central Georgia Technical College,Georgia,5100288,11496965,20061000,36658253,0
KY,00197600,Morehead State University,Kentucky,6016440,11119678,19479000,36615118,0
MO,00248000,Lindenwood University,Missouri,6706309,10755236,18921000,36382545,0
TN,00399800,Chattanooga State Community College,Tennessee,5283482,11325214,19762000,36370696,0
NY,00284600,State University Of New York At New Paltz,New York,6537407,10821964,18954000,36313371,0
AR,00110100,University Of Arkansas At Little Rock,Arkansas,5956500,11008760,19287000,36252260,0
MD,00206200,Bowie State University,Maryland,6596246,10788569,18806000,36190815,0
VA,00376400,Virginia State University,Virginia,6855810,10694110,18639000,36188920,57383000
OH,00306800,Lorain County Community College,Ohio,4917956,11339576,19872000,36129532,40485000
LA,03956300,South Louisiana Community College,Louisiana,5645949,11077607,19326000,36049556,0
MA,00218800,Salem State University,Massachusetts,6512818,10710632,18782000,36005450,0
FL,00146700,Bethune Cookman University,Florida,6648501,10731233,18601000,35980734,0
LA,00202100,Northwestern State University,Louisiana,5647034,11025862,19278000,35950896,0
NY,00287500,Onondaga Community College,New York,5222555,11118319,19484000,35824874,0
GA,00562000,Chattahoochee Technical College,Georgia,4903653,11215138,19677000,35795791,0
WY,00393200,University Of Wyoming,Wyoming,6613580,10546335,18627000,35786915,515121000
TX,04248500,Texas A&M University-San Antonio,Texas,5613425,10982357,19141000,35736782,0
AZ,03156300,Estrella Mountain Community College,Arizona,4856585,11191621,19610000,35658206,0
MS,00242700,Northwest Mississippi Community College,Mississippi,5787016,10861070,18998000,35646086,0
FL,00153800,University Of Tampa (The),Florida,6941444,10370376,18283000,35594820,0
TN,01269300,Pellissippi State Community College,Tennessee,5171189,10977362,19281000,35429551,11604000
FL,03549300,Ultimate Medical Academy,Florida,469150,12230799,22713000,35412949,0
NC,00406200,Pitt Community College,North Carolina,5510793,10858478,18997000,35366271,0
WI,00391900,University Of Wisconsin - Lacrosse,Wisconsin,6789642,10311865,18212000,35313507,0
KY,00524400,Bluegrass Community & Technical College,Kentucky,4961119,11036893,19303000,35301012,0
MA,00221000,University Of Massachusetts - Dartmouth,Massachusetts,6288232,10476776,18352000,35117008,0
IN,00182700,Purdue University Northwest,Indiana,5824998,10594351,18589000,35008349,0
NC,00531700,Forsyth Technical Community College,North Carolina,4933805,9807067,20195000,34935872,0
TX,00359000,Mclennan Community College,Texas,4898030,10915188,19117000,34930218,0
WI,00392400,University Of Wisconsin - Stevens Point,Wisconsin,6312792,9947577,18504000,34764369,0
IN,00182800,Purdue University Fort Wayne,Indiana,5589305,10558946,18545000,34693251,0
SC,00695100,University Of South Carolina Upstate,South Carolina,6104655,10394456,18124000,34623111,0
PA,00332000,East Stroudsburg University Of Pennsylvania,Pennsylvania,6469323,10246794,17903000,34619117,0
MN,01054600,Century College,Minnesota,4996271,10765178,18844000,34605449,0
TX,00354000,Amarillo College,Texas,4794394,10841767,18938000,34574161,0
KY,00197700,Murray State University,Kentucky,6270769,10236265,17965000,34472034,89480000
MI,00225100,Delta College,Michigan,5146606,10658617,18631000,34436223,0
CA,00711500,Moorpark College,California,5143560,10545381,18699000,34387941,0
FL,00150400,"State College Of Florida, Manatee-Sarasota",Florida,5023266,10660667,18697000,34380933,0
LA,00202000,University Of Louisiana At Monroe,Louisiana,5777764,10393276,18208000,34379040,0
AL,00102000,Jacksonville State University,Alabama,6050640,10296298,18020000,34366938,0
NC,00298600,Winston-Salem State University,North Carolina,6117980,10294709,17902000,34314689,0
FL,00152100,Southeastern University,Florida,4820567,8993865,15788000,29602432,0
MN,01037400,Metropolitan State University,Minnesota,5159002,10533046,18397000,34089048,6017000
NY,00286800,Hudson Valley Community College,New York,5108581,10491761,18480000,34080342,0
GA,00159000,Savannah State University,Georgia,6374932,10115570,17553000,34043502,0
IN,00180800,University Of Southern Indiana,Indiana,5890282,10178801,17918000,33987083,0
AL,00100500,Alabama State University,Alabama,6284463,10072950,17575000,33932413,0
OK,00316100,Northeastern State University,Oklahoma,5676974,10255813,17916000,33848787,0
MO,00245600,Columbia College,Missouri,4385319,10707484,18715000,33807803,0
IL,00165000,City Colleges Of Chicago - Malcolm X College,Illinois,4919757,10502178,18381000,33802935,0
WA,00377300,Clark College,Washington,5205413,10339712,18170000,33715125,0
WI,00386300,Marquette University,Wisconsin,6646735,9752321,17303000,33702056,698021000
SD,00347100,South Dakota State University,South Dakota,6020168,9990468,17669000,33679636,132678000
FL,00152600,Saint Leo University,Florida,4579587,10573988,18512000,33665575,0
TX,01171100,University Of Houston - Clear Lake,Texas,5555369,10205153,17892000,33652522,0
MN,00795400,Normandale Community College,Minnesota,4802575,10454594,18376000,33633169,0
TX,00366500,West Texas A&M University,Texas,5764767,10101563,17714000,33580330,0
MA,00212800,Boston College,Massachusetts,6448576,9728036,17397000,33573612,2523300000
MA,00217500,Quinsigamond Community College,Massachusetts,4828361,10469338,18267000,33564699,0
CT,00142600,Yale University,Connecticut,6851139,9389616,17320000,33560755,30314800000
ID,04211800,College Of Western Idaho,Idaho,4030648,10671497,18852000,33554145,0
GA,00157900,Augusta University,Georgia,6145342,9937667,17469000,33552009,0
IN,00184300,Vincennes University,Indiana,4866528,10327711,18333000,33527239,0
NC,00292000,Duke University,North Carolina,6714022,9388487,17421000,33523509,8609004000
IL,00165500,Wilbur Wright College,Illinois,5035279,10302824,18170000,33508103,0
FL,00147100,College Of Central Florida,Florida,5063707,10354340,18073000,33491047,72029000
NJ,00260700,Fairleigh Dickinson University,New Jersey,5771203,10026608,17685000,33482811,91625000
CA,00133400,Ventura College,California,4581538,10430052,18419000,33430590,0
MI,00231500,Schoolcraft College,Michigan,4676826,10389325,18273000,33339151,0
CA,00130800,Reedley College,California,4243892,10534587,18560000,33338479,0
SC,00492500,Horry - Georgetown Technical College,South Carolina,5158587,10253428,17878000,33290015,0
IL,00166500,Columbia College Chicago,Illinois,6341542,9790759,17135000,33267301,0
CT,00698200,Naugatuck Valley Community College,Connecticut,3819528,8536320,20873000,33228848,0
MI,00230100,Northern Michigan University,Michigan,5994618,9891128,17337000,33222746,15400000
IL,00163600,Southwestern Illinois College,Illinois,4677515,10331215,18191000,33199730,0
MN,00236200,Minneapolis Community And Technical College,Minnesota,4640122,10358338,18086000,33084460,0
TN,00814500,Nashville State Community College,Tennessee,4689355,10323371,18051000,33063726,0
TX,00356300,Del Mar College,Texas,3854029,10600037,18596000,33050066,0
LA,00201500,University Of New Orleans (The),Louisiana,5581887,9972376,17484000,33038263,0
MD,00207700,Johns Hopkins University,Maryland,6266940,9496212,17260000,33023152,6275939000
TX,00361100,South Plains College,Texas,5182219,10118799,17691000,32992018,0
DC,00143400,American University (The),District of Columbia,6314017,9543682,17070000,32927699,0
WI,00962100,Herzing University,Wisconsin,4328833,10441249,18122000,32892082,0
NY,00284300,Suny College At Cortland,New York,6245138,9642783,16892000,32779921,0
MD,00817500,Howard Community College,Maryland,4800099,10064936,17703000,32568035,0
MN,00553300,Saint Paul College - A Community & Technical College,Minnesota,4580520,10171146,17756000,32507666,0
MO,00252000,Washington University In St. Louis,Missouri,6368472,9322223,16806000,32496695,7953986000
MA,00217600,Bristol Community College,Massachusetts,4686502,10097346,17629000,32412848,0
CA,00121600,University Of La Verne,California,5658977,9709997,17020000,32388974,111994000
AR,00111000,University Of Arkansas At Fort Smith,Arkansas,5511303,9777559,17053000,32341862,0
DC,00144500,Georgetown University,District of Columbia,6110643,9301024,16800000,32211667,1822484000
MD,00209100,Salisbury University,Maryland,5959457,9493680,16709000,32162137,56034000
PR,02100000,Universidad Politecnica De Puerto Rico,Puerto Rico,5734996,9627350,16750000,32112346,0
IL,00177300,Triton College,Illinois,4211898,10068612,17778000,32058510,0
IL,00167500,Elgin Community College,Illinois,4600718,9931520,17497000,32029238,6973000
NC,00532000,Cape Fear Community College,North Carolina,4726439,9895172,17347000,31968611,0
AL,00101300,Calhoun Community College,Alabama,4392248,10001547,17570000,31963795,0
TN,00991200,Volunteer State Community College,Tennessee,4689090,9915202,17352000,31956292,0
CO,00954200,Community College Of Denver,Colorado,4443177,9998358,17497000,31938535,0
GA,01048700,West Georgia Technical College,Georgia,4442806,10007656,17473000,31923462,0
NY,00710900,Suny College At Old Westbury,New York,5522673,9608491,16756000,31887164,0
GA,00155900,Clark Atlanta University,Georgia,6064349,9435889,16384000,31884238,0
CA,00120600,Golden West College,California,4318142,9911380,17502000,31731522,0
TX,01116300,University Of Texas At Tyler,Texas,5194610,9592692,16870000,31657302,0
WA,00379300,Spokane Community College,Washington,4173204,9935519,17521000,31629723,0
IL,00177400,University Of Chicago (The),Illinois,6207010,8988981,16299000,31494991,0
AZ,03072200,Chandler - Gilbert Community College,Arizona,4350989,9757937,17329000,31437926,0
PR,00393700,Universidad Del Sagrado Corazón,Puerto Rico,5395359,9498506,16494000,31387865,0
IN,00182200,Indiana Wesleyan University,Indiana,4543246,9731895,17082000,31357141,204472000
CT,00803700,Gateway Community College,Connecticut,4296723,9850045,17210000,31356768,0
CA,00891800,Saddleback College,California,4296103,9691596,17348000,31335699,0
NY,00273200,Hofstra University,New York,6249515,9026013,16022000,31297528,622235000
NJ,00794700,Beth Medrash Govoha Of America,New Jersey,5899593,9210836,16175000,31285429,0
PA,00324200,Carnegie Mellon University,Pennsylvania,5735086,9045100,16300000,31080186,2542650000
MD,00205800,Anne Arundel Community College,Maryland,4315345,9667547,17083000,31065892,0
LA,02055400,Bossier Parish Community College,Louisiana,3915911,9852065,17154000,30921976,0
PR,00394300,University Of Puerto Rico - Humacao University College,Puerto Rico,5664236,9236475,16010000,30910711,0
AZ,00107100,Arizona Western College,Arizona,4528738,9589819,16774000,30892557,0
MS,00239600,Alcorn State University,Mississippi,5886916,9094866,15791000,30772782,0
PA,00445200,Montgomery County Community College,Pennsylvania,4090103,9628984,16971000,30690087,0
PA,00332500,Millersville University Of Pennsylvania,Pennsylvania,5617301,9089274,15962000,30668575,0
NC,00292800,Fayetteville State University,North Carolina,5084687,9308810,16228000,30621497,24341000
CA,02539500,Irvine Valley College,California,4485810,9394933,16692000,30572743,0
VA,00375900,J Sargeant Reynolds Community College,Virginia,4151184,9595572,16821000,30567756,0
NY,00284700,Suny College At Oneonta,New York,5740817,9003120,15766000,30509937,0
ND,00300500,University Of North Dakota,North Dakota,5491551,8980342,15956000,30427893,0
NJ,00263200,Seton Hall University,New Jersey,5749918,8857951,15734000,30341869,264514000
MI,00694900,Kalamazoo Valley Community College,Michigan,4249299,9456126,16593000,30298425,17756000
CA,00116200,Chabot College,California,4156840,9409398,16689000,30255238,0
LA,00201700,Mcneese State University,Louisiana,5456361,8997322,15771000,30224683,0
MN,00239400,Winona State University,Minnesota,5696956,8890555,15629000,30216511,0
CA,01146000,National University,California,4563497,9227970,16422000,30213467,216382000
NY,00289400,University Of Rochester,New York,6011698,8616921,15479000,30107619,2239720000
PR,00720600,University Of Puerto Rico - Cayey University College,Puerto Rico,5738057,8907729,15439000,30084786,0
PR,01212300,"University Of Puerto Rico, Aguadilla Regional College",Puerto Rico,5899782,8844300,15334000,30078082,0
CA,00111700,Azusa Pacific University,California,5548456,8848314,15610000,30006770,0
CA,00120900,Hartnell Community College,California,3615339,9501755,16836000,29953094,0
NE,02508300,Southeast Community College,Nebraska,4282436,9303287,16347000,29932723,0
AL,00106000,Coastal Alabama Community College,Alabama,4437762,9254055,16218000,29909817,0
CA,04173500,Moreno Valley College,California,3681844,9460917,16674000,29816761,0
OH,00575300,Owens Community College,Ohio,3937786,9317892,16429000,29684678,0
CA,01245200,Evergreen Valley College,California,3949985,9289992,16388000,29627977,0
OH,01034500,Cincinnati State Technical & Community College,Ohio,4228115,9223681,16172000,29623796,0
TX,00363600,Texas Christian University,Texas,5728641,8566705,15238000,29533346,1708867000
NJ,00262400,Ocean County College,New Jersey,4265169,9137920,16095000,29498089,0
TN,00537800,Northeast State Community College,Tennessee,4488316,8967575,15643000,29098891,12483000
GA,00559900,Augusta Technical College,Georgia,4386678,8997908,15656000,29040586,0
AL,00101600,University Of North Alabama,Alabama,5002648,8666299,15192000,28860947,0
LA,00200500,Nicholls State University,Louisiana,5057520,8626311,15095000,28778831,0
TX,00357800,University Of The Incarnate Word,Texas,5219687,8535960,15010000,28765647,142071000
CA,00128900,Shasta College,California,3673274,9115270,15977000,28765544,0
DE,00142800,Delaware State University,Delaware,5565920,8459446,14739000,28764366,0
PA,00332600,Shippensburg University Of Pennsylvania,Pennsylvania,5436200,8476435,14850000,28762635,0
WA,00500000,Pierce College,Washington,3925203,8964719,15800000,28689922,0
CA,01182000,San Diego Miramar College,California,3235898,9144193,16296000,28676091,0
CA,00112400,Cabrillo College,California,4027260,8885242,15729000,28641502,0
TN,00353100,University Of Tennessee - Martin,Tennessee,5110311,8551121,14953000,28614432,0
WI,00530100,Northeast Wisconsin Technical College,Wisconsin,3736257,8993456,15845000,28574713,0
GA,00395600,Dalton State College,Georgia,4768309,8679276,15116000,28563585,0
TX,00359300,Navarro College,Texas,4101645,8879685,15578000,28559330,0
AR,02075300,University Of Arkansas - Pulaski Technical College,Arkansas,4476116,9423959,14656000,28556075,0
CA,00111100,Allan Hancock College,California,3853901,8924491,15766000,28544392,0
SC,00345600,Winthrop University,South Carolina,5382130,8423174,14737000,28542304,57949000
PR,00965200,"University Of Puerto Rico, Ponce",Puerto Rico,5314251,8364340,14856000,28534591,0
TN,00353500,Vanderbilt University,Tennessee,5632423,8200868,14679000,28512291,6270877000
TX,00355800,North Central Texas College,Texas,3862598,8921316,15708000,28491914,0
AL,00831000,Auburn University Montgomery,Alabama,5075473,8523023,14878000,28476496,0
LA,00202900,Tulane University,Louisiana,5590189,8175012,14674000,28439201,1429707000
NY,00284900,State University Of New York College At Plattsburgh,New York,5258169,8423237,14725000,28406406,0
IN,00184000,University Of Notre Dame,Indiana,5793244,7969565,14590000,28352809,11268365000
KS,00192600,Pittsburg State University,Kansas,5318769,8353746,14657000,28329515,76528000
MO,00250600,Saint Louis University,Missouri,5141085,8305153,14862000,28308238,1252678000
PA,00681000,Lehigh Carbon Community College,Pennsylvania,3873075,8853093,15507000,28233168,0
NY,00284400,Suny At Fredonia,New York,5513590,8267340,14420000,28200930,0
NJ,00773000,Rowan College At Burlington County,New Jersey,3750316,8855454,15595000,28200770,0
ME,00205400,University Of Southern Maine,Maine,4616245,8534700,15016000,28166945,0
NY,00266600,Adelphi University,New York,5246966,8279486,14638000,28164452,187211000
VA,00687100,Thomas Nelson Community College,Virginia,3853969,8822513,15468000,28144482,0
PA,00339500,Pennsylvania College Of Technology,Pennsylvania,5341470,8301655,14480000,28123125,0
NY,00286200,Suny Broome Community College,New York,4364871,8632801,15094000,28091672,0
CA,00116400,Chapman University,California,5505229,8137393,14448000,28090622,417705000
WA,00378000,Green River College,Washington,4763642,8421086,14866000,28050728,0
NY,00287100,Mohawk Valley Community College - Suny Office Of Community Colleges,New York,4368811,8603935,15057000,28029746,0
GA,00158000,Mercer University,Georgia,5265925,8211054,14489000,27965979,0
MO,00248800,Missouri Southern State University,Missouri,4756273,8447302,14728000,27931575,0
AL,00102200,Jefferson State Community College,Alabama,3729878,8768415,15424000,27922293,0
CA,00126600,Laney College,California,3313469,8854083,15664000,27831552,0
TX,03064600,Texas Southmost College,Texas,3608280,8774434,15365000,27747714,0
OR,00319600,Lane Community College,Oregon,3014266,8943191,15732000,27689457,0
TX,00358300,Lee College,Texas,4057094,8567819,15048000,27672913,0
CO,02116300,Pueblo Community College,Colorado,3638453,8728074,15283000,27649527,0
GA,00950700,Georgia Highlands College,Georgia,4220236,8527676,14892000,27639912,0
MO,00251700,Missouri University Of Science And Technology,Missouri,5205598,8118979,14310000,27634577,0
CA,01034000,Los Medanos College,California,3838971,8585259,15148000,27572230,0
GA,00562100,Southern Crescent Technical College,Georgia,3912287,8586232,14946000,27444519,0
NJ,00259600,Atlantic Cape Community College,New Jersey,3960342,8555148,14917000,27432490,0
MS,00243000,Pearl River Community College,Mississippi,4385949,8368310,14586000,27340259,0
OH,00301200,Ashland University,Ohio,3987716,8488692,14846000,27322408,0
NY,02066200,"New School, The",New York,4996686,7998165,14252000,27246851,0
TX,00360800,Saint Philip'S College,Texas,3427506,8602242,15215000,27244748,0
FL,00146600,Barry University,Florida,5027398,8001386,14127000,27155784,45448000
WI,00391500,University Of Wisconsin - Stout,Wisconsin,4952605,8039386,14150000,27141991,0
MI,00232700,University Of Michigan - Flint,Michigan,4600155,8146874,14284000,27031029,0
PA,00325800,Duquesne University Of The Holy Spirit,Pennsylvania,5373970,7783815,13873000,27030785,488351000
NJ,00474000,Mercer County Community College,New Jersey,3851115,8358417,14679000,26888532,0
WI,00392100,University Of Wisconsin - Platteville,Wisconsin,4792670,7652424,14419000,26864094,0
CA,04176100,Norco College,California,3523056,8421677,14892000,26836733,0
MS,00240900,Itawamba Community College,Mississippi,4419244,8115985,14154000,26689229,0
TX,02341300,Palo Alto College,Texas,3240943,8485780,14933000,26659723,0
OH,00312700,University Of Dayton,Ohio,5197738,7694898,13766000,26658636,604176000
KS,00194900,Washburn University - Topeka,Kansas,4500174,8024016,14117000,26641190,0
CT,00140200,Quinnipiac University,Connecticut,5345199,7632879,13616000,26594078,556604000
IN,00180400,University Of Indianapolis,Indiana,4902143,7840045,13754000,26496188,109448000
MO,00249600,Northwest Missouri State University,Missouri,4792789,7854065,13791000,26437854,0
AL,00787100,George C. Wallace State Community College,Alabama,4064802,8136032,14196000,26396834,0
CA,00119200,Cuesta College,California,3527579,8257338,14604000,26388917,35196000
IL,00163400,Aurora University,Illinois,4697683,7853760,13760000,26311443,0
MI,00227400,Jackson College,Michigan,3892134,8114820,14126000,26132954,0
TX,00361400,Southwest Texas Junior College,Texas,3736958,8149245,14243000,26129203,0
IL,00675300,Illinois Central College,Illinois,3704633,8110353,14290000,26104986,0
IL,00167400,Eastern Illinois University,Illinois,4506779,7820433,13746000,26073212,84387000
VA,00400400,John Tyler Community College,Virginia,3448784,8170985,14407000,26026769,3785000
SC,00492600,Tri-County Technical College,South Carolina,4246483,7917841,13859000,26023324,27343000
WA,00376900,Bellevue College,Washington,4145089,7839658,14024000,26008747,0
MA,00807800,Springfield Technical Community College,Massachusetts,3845054,8068676,14068000,25981730,0
IN,00181600,Indiana University - South Bend,Indiana,4500518,7768280,13567000,25835798,0
CA,00132900,University Of The Pacific,California,5164869,7452559,13153000,25770428,463313000
MN,00234500,University Of Saint Thomas,Minnesota,5005202,7468750,13293000,25766952,0
NY,00280300,Rensselaer Polytechnic Institute,New York,4828782,7283082,13563000,25674864,739648000
GA,00854300,Atlanta Technical College,Georgia,3869156,7962803,13836000,25667959,0
NY,01028600,Suny Empire State College,New York,3411359,8060895,14170000,25642254,0
MS,00240800,Holmes Community College,Mississippi,3916962,7897652,13792000,25606614,0
TX,00359200,Midwestern State University,Texas,4413874,7678441,13427000,25519315,0
PR,03016000,University Of Puerto Rico Carolina Regional College,Puerto Rico,4491903,7670211,13309000,25471114,0
WA,00380500,Yakima Valley College,Washington,4041726,7803497,13600000,25445223,0
CO,00136500,Colorado State University-Pueblo,Colorado,3959862,7745423,13722000,25427285,0
KS,00190600,Butler County Community College,Kansas,3631932,7901125,13881000,25414057,0
MA,00221800,Suffolk University,Massachusetts,4935367,7382175,13033000,25350542,256300000
MA,00993600,Middlesex Community College,Massachusetts,3704343,7847872,13797000,25349215,0
NJ,00264200,College Of New Jersey (The),New Jersey,5028131,7299736,12995000,25322867,0
OR,00320400,Mount Hood Community College,Oregon,3385658,7917862,14019000,25322520,0
NJ,00261600,Monmouth University,New Jersey,4935299,7371976,12954000,25261275,107085000
NJ,00773100,Raritan Valley Community College,New Jersey,3819720,7748750,13657000,25225470,0
CT,00451300,Housatonic Community College,Connecticut,3450869,7936666,13806000,25193535,0
NV,02107700,Truckee Meadows Community College,Nevada,3347251,7834837,13868000,25050088,0
MA,00217800,Massachusetts Institute Of Technology,Massachusetts,5045387,7130129,12812000,24987516,17569328000
WA,00377400,Columbia Basin College,Washington,3840410,7650276,13434000,24924686,0
CA,00134400,Yuba College,California,3748918,7652045,13399000,24799963,0
CA,01164900,Loyola Marymount University,California,4723135,7219025,12852000,24794160,0
MA,00217700,Massasoit Community College,Massachusetts,3581373,7679157,13484000,24744530,0
PA,00331600,California University Of Pennsylvania,Pennsylvania,4312587,7410738,13000000,24723325,0
MN,00233200,Anoka-Ramsey Community College,Minnesota,3580976,7650597,13470000,24701573,0
GA,00561500,Southern Regional Technical College,Georgia,3604073,7686039,13383000,24673112,0
MA,00219000,Worcester State University,Massachusetts,4222833,7394799,13026000,24643632,0
CA,01284200,Oxnard College,California,3127211,7788765,13663000,24578976,0
AL,00101700,Gadsden State Community College,Alabama,3756166,7581323,13220000,24557489,0
MA,00217000,Holyoke Community College,Massachusetts,3685390,7592856,13239000,24517246,0
CO,00137100,University Of Denver,Colorado,4626269,7105908,12734000,24466177,786425000
WA,00379600,Tacoma Community College,Washington,3835874,7472853,13127000,24435727,0
MA,00218900,Westfield State University,Massachusetts,4512060,7216874,12670000,24398934,0
RI,00340100,Brown University,Rhode Island,4842231,7008633,12533000,24383864,3976694000
TX,00358000,Kilgore College,Texas,3908886,7463341,12972000,24344227,0
AL,00101800,George C. Wallace Community College,Alabama,3655757,7531363,13133000,24320120,0
IL,00693100,Waubonsee Community College,Illinois,3198731,7586569,13494000,24279300,0
NY,00285000,State University Of New York College At Potsdam,New York,4389510,7227985,12584000,24201495,0
MA,00217300,North Shore Community College,Massachusetts,3446732,7520742,13151000,24118474,0
TN,00886300,Walters State Community College,Tennessee,3688117,7421588,12977000,24086705,0
NJ,00934400,Ramapo College Of New Jersey,New Jersey,4606705,7054659,12412000,24073364,21364000
WI,00392300,University Of Wisconsin - River Falls,Wisconsin,4427466,7099284,12476000,24002750,0
CT,00139700,University Of New Haven,Connecticut,4642795,6999198,12336000,23977993,0
CT,00139200,Manchester Community College,Connecticut,3235201,7524805,13179000,23939006,0
CT,00138000,Western Connecticut State University,Connecticut,4256393,7148969,12533000,23938362,0
MI,00229200,Michigan Technological University,Michigan,4605779,6991814,12339000,23936593,113645000
KY,00195900,Campbellsville University,Kentucky,3201468,7256937,13475000,23933405,0
AL,00105900,Lawson State Community College,Alabama,3522022,7444227,12941000,23907249,0
CT,00142200,University Of Hartford,Connecticut,4467175,7020751,12399000,23886926,182812000
CT,00142500,Eastern Connecticut State University,Connecticut,4433725,7060353,12363000,23857078,0
NJ,00772900,County College Of Morris,New Jersey,3734038,7274185,12847000,23855223,0
CA,01255000,Los Angeles Mission College,California,2940483,7612456,13292000,23844939,0
WI,00538900,Gateway Technical College,Wisconsin,2614556,7675437,13535000,23824993,0
MA,00216500,Mcphs University,Massachusetts,4414483,6808137,12549000,23771620,0
OR,00320900,Western Oregon University,Oregon,4281683,7059841,12351000,23692524,0
SC,00399200,Piedmont Technical College,South Carolina,3433957,7392118,12864000,23690075,0
GU,00393500,University Of Guam,Guam,4564698,6947461,12103000,23615159,0
NY,00286400,Dutchess Community College,New York,3592574,7233073,12767000,23592647,0
NY,00285400,Suny College Of Technology At Alfred,New York,4425878,6987691,12158000,23571569,0
CA,00125300,Fresno Pacific University,California,4121557,7068175,12326000,23515732,0
DE,00794800,Wilmington University,Delaware,3126974,7042779,13320000,23489753,0
NC,00403300,Asheville Buncombe Technical Community College,North Carolina,3686607,7164686,12605000,23456293,0
MA,00221900,Tufts University,Massachusetts,4765237,6655929,12009000,23430166,1867962000
NY,00278200,New York Institute Of Technology,New York,4377210,6855681,12109000,23341891,0
IL,00711800,Parkland College,Illinois,3275003,7257218,12781000,23313221,0
WI,00974400,Fox Valley Technical College,Wisconsin,2598816,7452169,13245000,23295985,0
NY,00284500,Suny College At Geneseo,New York,4552123,6782413,11955000,23289536,0
TN,00347900,Belmont University,Tennessee,4597337,6711670,11957000,23266007,252091000
IN,00180500,Indiana Institute Of Technology,Indiana,3336999,7249335,12632000,23218334,137039000
SC,00342000,Benedict College,South Carolina,4372336,6899448,11946000,23217784,0
NY,00273900,Ithaca College,New York,4583253,6732724,11889000,23204977,347335000
CA,02111300,Cuyamaca College,California,2918721,7329288,12907000,23155009,0
NY,00287400,Niagara County Community College,New York,3598909,7096692,12359000,23054601,0
TX,00361300,Southern Methodist University,Texas,4598259,6580843,11850000,23029102,1663864000
PA,00328700,La Salle University,Pennsylvania,4277300,6800498,11944000,23021798,80311000
AZ,02177500,Rio Salado Community College,Arizona,2531870,7331461,13123000,22986331,0
CO,02276900,Community College Of Aurora,Colorado,3035626,7224037,12720000,22979663,0
GA,00402400,Georgia Northwestern Technical College,Georgia,3182360,7197142,12564000,22943502,0
SC,00399400,Spartanburg Community College,South Carolina,3358632,7124748,12428000,22911380,0
MA,00218400,Fitchburg State University,Massachusetts,3910925,6854502,12103000,22868427,0
GA,00156600,Fort Valley State University,Georgia,4166439,6827893,11853000,22847332,0
AR,00108600,University Of Arkansas At Pine Bluff,Arkansas,4295429,6774295,11748000,22817724,0
NY,00287700,Rockland Community College,New York,3626632,6947584,12234000,22808216,0
MA,00217400,Northern Essex Community College,Massachusetts,3271644,7115735,12415000,22802379,0
CA,01039500,University Of San Diego,California,4426552,6592664,11746000,22765216,545552000
NY,00679100,Suny College At Purchase,New York,4290517,6722248,11752000,22764765,0
WI,00389900,University Of Wisconsin - Green Bay,Wisconsin,3504931,6769674,12470000,22744605,0
OH,00302400,Case Western Reserve University,Ohio,4514183,6502716,11714000,22730899,1866500000
PA,01038800,Reading Area Community College,Pennsylvania,3184345,7099987,12365000,22649332,0
NY,01118900,United Talmudical Seminary,New York,4482702,6631109,11501000,22614811,0
CA,03871300,Folsom Lake College,California,2957869,7090043,12555000,22602912,0
NC,00291300,Campbell University,North Carolina,4307900,6604314,11634000,22546214,0
CT,00140300,Sacred Heart University,Connecticut,4305177,6550955,11652000,22508132,177133000
WA,00377600,Everett Community College,Washington,3327536,6893997,12254000,22475533,0
MO,00249800,Park University,Missouri,2805843,7132764,12514000,22452607,0
FL,00146900,Florida Institute Of Technology,Florida,3607645,6819739,12013000,22440384,87759000
TN,00991400,Roane State Community College,Tennessee,3314382,6955614,12163000,22432996,0
KY,00199700,Somerset Community College,Kentucky,3029445,7072505,12320000,22421950,0
SD,00347400,University Of South Dakota,South Dakota,3634766,6766389,11975000,22376155,244474000
AZ,00107400,Grand Canyon University,Arizona,22351397,0,0,22351397,0
DC,00144100,University Of The District Of Columbia,District of Columbia,3609526,6814702,11912000,22336228,0
NC,00531800,Catawba Valley Community College,North Carolina,2557958,5203663,14559000,22320621,0
MS,00241100,Jones County Junior College,Mississippi,3808681,6717113,11741000,22266794,0
AR,00110700,Southern Arkansas University,Arkansas,4025613,6634144,11587000,22246757,0
OK,00918500,Rose State College,Oklahoma,3084740,6949136,12194000,22227876,0
CO,00954300,Red Rocks Community College,Colorado,3149018,6889441,12160000,22198459,0
AR,03063300,Northwest Arkansas Community College,Arkansas,3113618,6897894,12153000,22164512,0
GA,00562400,Columbus Technical College,Georgia,3131902,6948954,12081000,22161856,0
SC,00344600,South Carolina State University,South Carolina,4062087,6611191,11484000,22157278,0
CT,00139900,Norwalk Community College,Connecticut,3189661,6885402,12059000,22134063,0
MO,00249000,Missouri Western State University,Missouri,3722351,6689868,11705000,22117219,0
GA,00561800,Savannah Technical College,Georgia,3257084,6876107,11980000,22113191,0
CA,04253400,Clovis Community College,California,2870984,6951508,12276000,22098492,0
NY,03802300,Uta Mesivta Of Kiryas Joel,New York,4265324,6530186,11301000,22096510,0
FM,01034300,College Of Micronesia-Fsm,Micronesia,3640313,6749563,11684000,22073876,0
MN,00237000,North Hennepin Community College,Minnesota,3021425,6915297,12128000,22064722,0
IA,00459800,Iowa Western Community College,Iowa,3175383,6848417,12013000,22036800,0
IL,00989600,Oakton Community College,Illinois,2762839,6923930,12344000,22030769,5605000
IL,00174700,Rock Valley College,Illinois,3290405,6777335,11948000,22015740,0
CA,03695700,Santiago Canyon College,California,2893906,6866798,12250000,22010704,0
PA,00681100,Luzerne County Community College,Pennsylvania,3206325,6817714,11920000,21944039,0
PA,00332100,Edinboro University Of Pennsylvania,Pennsylvania,4181685,6446463,11298000,21926148,0
TX,00362100,St. Edward'S University,Texas,4142345,6472273,11309000,21923618,107026000
IL,00176800,Saint Xavier University,Illinois,4057142,6501237,11335000,21893379,0
NY,00287600,Orange County Community College,New York,3405395,6706076,11774000,21885471,0
CA,00129200,Solano Community College,California,3130214,6745292,11978000,21853506,0
NE,00255100,University Of Nebraska - Kearney,Nebraska,3925967,6501525,11417000,21844492,0
PA,01239300,Thomas Jefferson University,Pennsylvania,4240183,6346019,11234000,21820202,0
WA,00378700,Seattle Central College,Washington,3252598,6694704,11851000,21798302,0
WI,00530400,Chippewa Valley Technical College,Wisconsin,2765463,6860983,12110000,21736446,0
OH,00485200,Clark State Community College,Ohio,2914627,6839500,11967000,21721127,0
WA,00954400,Spokane Falls Community College,Washington,3458313,6624036,11589000,21671349,0
IL,00170700,Lewis University,Illinois,3978861,6397561,11269000,21645422,0
TN,00348300,Columbia State Community College,Tennessee,3285220,6664682,11688000,21637902,0
PA,00338800,Villanova University,Pennsylvania,4299419,6189181,11110000,21598600,766903000
WA,00378100,Highline College,Washington,3519738,6541137,11534000,21594875,0
MD,00207200,Frostburg State University,Maryland,3925040,6416427,11238000,21579467,0
OR,01018200,Rogue Community College,Oregon,2523281,6927272,12117000,21567553,0
IL,00164100,Bradley University,Illinois,4276013,6267487,11023000,21566500,320313000
IN,00181700,Indiana University Southeast,Indiana,3667290,6482268,11350000,21499558,0
OK,00315000,Cameron University,Oklahoma,3498279,6554643,11434000,21486922,0
MA,00218500,Framingham State University,Massachusetts,3897751,6356373,11208000,21462124,0
PA,00323900,Bucks County Community College,Pennsylvania,3016924,6658039,11777000,21451963,0
KS,00192500,Kansas City Kansas Community College,Kansas,2965092,6705791,11754000,21424883,0
GA,00560000,Athens Technical College,Georgia,2983204,6704867,11704000,21392071,0
PR,02260600,Nuc University,Puerto Rico,21367165,0,0,21367165,0
NJ,00262700,Princeton University,New Jersey,2424099,6776453,12166000,21366552,26116022000
LA,04130100,Louisiana Delta Community College,Louisiana,2963756,6698731,11666000,21328487,0
CA,00122400,Los Angeles Harbor College,California,2906139,6734763,11668000,21308902,0
AZ,02217100,Pima Medical Institute,Arizona,21285691,0,0,21285691,0
NC,00575400,Rowan-Cabarrus Community College,North Carolina,2845506,6289645,12132000,21267151,0
WI,00501500,University Of Wisconsin - Parkside,Wisconsin,3781946,6364119,11118000,21264065,0
IA,00407500,Eastern Iowa Community College District,Iowa,2709712,6681568,11791000,21182280,0
GA,00160200,Georgia College & State University,Georgia,4082028,6172402,10926000,21180430,0
IL,00914500,Governors State University,Illinois,3702601,6348024,11096000,21146625,0
IL,00164800,City Colleges Of Chicago Harry S Truman College,Illinois,3220360,6444909,11446000,21111269,0
NJ,00263800,Saint Peter'S University,New Jersey,3914585,6239918,10870000,21024503,0
OH,00680400,Lakeland Community College,Ohio,3073894,6507072,11432000,21012966,0
SC,00922600,Francis Marion University,South Carolina,4141139,6135642,10699000,20975781,0
FL,00152300,Saint Johns River State College,Florida,2997937,6513669,11455000,20966606,0
TN,00683600,Motlow State Community College,Tennessee,3178784,6450317,11329000,20958101,0
VA,00371400,Hampton University,Virginia,4264342,6056070,10617000,20937412,282543000
MD,00206100,Baltimore City Community College,Maryland,2876155,6576135,11481000,20933290,0
AR,00109800,Henderson State University,Arkansas,3767931,5968320,11157000,20893251,0
ME,00552500,Southern Maine Community College,Maine,2897298,6511012,11429000,20837310,0
NY,00282500,Saint Joseph'S College,New York,3745728,6203959,10878000,20827687,0
IA,00186500,Iowa Central Community College,Iowa,3053198,6460442,11309000,20822640,0
SC,00399000,Florence - Darlington Technical College,South Carolina,3137478,6442168,11220000,20799646,0
PR,00502700,Inter American University Of Puerto Rico - Barranquitas Campus,Puerto Rico,3922288,6138003,10623000,20683291,0
OR,00318800,Central Oregon Community College,Oregon,3183671,6331672,11127000,20642343,22459000
NC,00531600,Coastal Carolina Community College,North Carolina,3371351,6284036,10986000,20641387,0
MS,00242600,Northeast Mississippi Community College,Mississippi,3583689,6212227,10814000,20609916,0
AL,00104000,Southern Union State Community College,Alabama,3196100,6311016,11066000,20573116,0
OR,00321900,Southern Oregon University,Oregon,3422079,6202456,10913000,20537535,0
CA,00112200,Biola University,California,3922227,6020986,10588000,20531213,0
VA,00376000,Virginia Western Community College,Virginia,2763297,6437437,11316000,20516734,0
IL,00717000,Lincoln Land Community College,Illinois,2715449,6445621,11348000,20509070,0
TX,00366800,Wharton County Junior College,Texas,3060606,6308810,11135000,20504416,0
WI,00384200,Concordia University,Wisconsin,3667367,6084278,10744000,20495645,0
VA,00866000,Germanna Community College,Virginia,2868710,6379347,11232000,20480057,0
PR,02165100,Edp University Of Puerto Rico,Puerto Rico,3158114,6321077,10994000,20473191,0
AL,00105000,Tuskegee University,Alabama,3756522,6066979,10633000,20456501,0
CA,04281700,Compton College,California,2538405,6356599,11554000,20449004,0
NH,00259100,Plymouth State University Of The University System Of New Hampshire,New Hampshire,3950921,5982786,10512000,20445707,0
GA,00154100,Abraham Baldwin Agricultural College,Georgia,3489407,6153343,10752000,20394750,0
TX,00362700,Temple College,Texas,2937041,6348038,11093000,20378079,0
GA,00157500,Gordon State College,Georgia,3427492,6168119,10743000,20338611,0
PR,02282800,Inter American University Of Puerto Rico - Fajardo Campus,Puerto Rico,3814392,6041453,10462000,20317845,0
CA,00126800,Porterville College,California,2896753,6326756,11032000,20255509,0
OH,00486100,University Of Northwestern Ohio,Ohio,3906341,5948044,10382000,20236385,0
RI,00784500,New England Institute Of Technology,Rhode Island,3676041,6026805,10495000,20197846,0
OH,00302600,Central State University,Ohio,3645811,6020363,10498000,20164174,0
AL,00569100,Shelton State Community College,Alabama,2965439,6242835,10927000,20135274,0
IL,00173300,National Louis University,Illinois,3034098,6209964,10891000,20135062,36103000
TN,00493700,Jackson State Community College,Tennessee,2838469,6278510,10978000,20094979,0
NY,00285900,Suny College Of Agriculture & Technology At Morrisville,New York,3527241,5952000,10461000,19940241,0
WA,00815500,Evergreen State College (The),Washington,3787631,5880338,10261000,19928969,0
MN,00553400,St. Cloud Technical And Community College,Minnesota,3055197,6143474,10723000,19921671,0
IL,00174900,Roosevelt University,Illinois,2927478,8905677,8047000,19880155,123353000
MO,00252100,Webster University,Missouri,3517058,5874946,10478000,19870004,139792000
KY,00199100,Elizabethtown Community And Technical College,Kentucky,2426734,6335828,11106000,19868562,0
MS,00240500,East Mississippi Community College,Mississippi,3398901,5993735,10469000,19861636,0
TN,00350000,Lee University,Tennessee,3518557,5925628,10395000,19839185,0
NM,00265100,Eastern New Mexico University,New Mexico,2914187,6119843,10775000,19809030,0
VA,00370500,College Of William & Mary,Virginia,3948268,5677858,10171000,19797126,0
NM,00266000,San Juan College,New Mexico,2737168,6182593,10848000,19767761,0
IL,00164900,Richard J Daley College-City Colleges Of Chicago,Illinois,2993998,6024050,10705000,19723048,0
AZ,00830300,Gateway Community College,Arizona,2707626,6158634,10826000,19692260,0
WV,00381200,Fairmont State University,West Virginia,3426559,5924797,10339000,19690356,0
MN,00236700,Minnesota State University Moorhead,Minnesota,3518533,5854257,10305000,19677790,0
NC,00544800,Durham Technical Community College,North Carolina,2803141,6117402,10738000,19658543,0
WA,00379000,Seattle University,Washington,3692919,5744310,10209000,19646229,0
CA,00119000,Contra Costa College,California,2477887,6196600,10939000,19613487,0
AZ,02623600,Paradise Valley Community College,Arizona,2586404,6141870,10876000,19604274,0
OK,00318100,Southwestern Oklahoma State University,Oklahoma,3443513,5864883,10278000,19586396,0
SC,00342400,Claflin University,South Carolina,3738216,5789854,10043000,19571070,0
WA,00378400,Olympic College,Washington,3129109,5935959,10501000,19566068,0
KS,00191500,Fort Hays State University,Kansas,2524075,6157168,10826000,19507243,114719000
CA,03035700,Las Positas College,California,2875491,5984875,10643000,19503366,0
WA,00500100,Edmonds Community College,Washington,2887689,5970004,10611000,19468693,0
OR,00693800,Linn-Benton Community College,Oregon,2606675,6082320,10750000,19438995,0
AZ,00728300,Central Arizona College,Arizona,3010509,5964675,10450000,19425184,0
MI,00224900,Davenport University,Michigan,2925271,5986150,10488000,19399421,0
AL,00103000,Bishop State Community College,Alabama,2871392,6026297,10500000,19397689,0
IL,00764400,Lake Land College,Illinois,2510560,6026021,10796000,19332581,0
SC,00399600,York Technical College,South Carolina,3059291,5917462,10349000,19325753,0
OH,00314400,Xavier University,Ohio,3122063,4794656,8554000,16470719,199275000
WA,00575200,Clover Park Technical College,Washington,3266340,5802995,10181000,19250335,0
CA,00859600,West Los Angeles College,California,2215810,6229160,10784000,19228970,0
CA,01014900,Pepperdine University,California,3620831,5540475,10054000,19215306,887461000
KY,00197900,West Kentucky Community And Technical College,Kentucky,2444514,6080214,10657000,19181728,0
CA,00119900,Foothill College,California,2401437,5970543,10790000,19161980,0
TX,00358800,University Of Mary Hardin-Baylor,Texas,3548693,5677713,9921000,19147406,0
SC,00399500,Central Carolina Technical College,South Carolina,2841256,5948759,10355000,19145015,0
MN,00554100,Minnesota State Community And Technical College,Minnesota,2832620,5922783,10388000,19143403,0
AR,00108500,University Of Arkansas At Monticello,Arkansas,3223313,5805440,10106000,19134753,0
KY,00196200,University Of The Cumberlands,Kentucky,2796798,5852797,10445000,19094595,0
GA,00525600,Wiregrass Georgia Technical College,Georgia,2558893,6012298,10523000,19094191,0
PR,02241900,Commonwealth Of Puerto Rico Department Of Education,Puerto Rico,3315937,5761089,9981000,19058026,0
MA,00220500,Quincy College,Massachusetts,2770136,5711961,10529000,19011097,0
TX,00366400,Weatherford College,Texas,2547296,5967424,10494000,19008720,0
NJ,00262800,Rider University,New Jersey,3648210,5567041,9779000,18994251,66593000
KS,00192700,Emporia State University,Kansas,3517620,5594046,9837000,18948666,79116000
IL,00169100,Illinois Institute Of Technology,Illinois,3730000,5464457,9704000,18898457,236887000
WA,00537200,South Puget Sound Community College,Washington,2999739,5742134,10079000,18820873,0
SC,00343500,Lander University,South Carolina,3536994,5567453,9700000,18804447,0
CA,00771300,Skyline College,California,2491579,5852939,10457000,18801518,0
NY,00753200,Finger Lakes Community College - Suny Office Of Community Colleges,New York,2655728,5791370,10326000,18773098,0
MA,00212600,Berklee College Of Music,Massachusetts,3573148,5472491,9683000,18728639,0
IL,00164000,Prairie State College,Illinois,2523787,5872996,10316000,18712783,0
AZ,00107900,Yavapai College,Arizona,2389592,5918433,10403000,18711025,0
IL,00176900,South Suburban College Of Cook County,Illinois,2208424,5973385,10515000,18696809,0
CA,00124200,Monterey Peninsula College,California,2415633,5845034,10372000,18632667,0
PR,01252500,Caribbean University,Puerto Rico,3713976,5445854,9468000,18627830,0
PA,00329000,Lincoln University,Pennsylvania,3494532,5521219,9589000,18604751,0
OH,00994200,Shawnee State University,Ohio,3572909,5463226,9540000,18576135,0
CO,00940100,Colorado Christian University,Colorado,2267714,5912413,10393000,18573127,0
MD,00210600,University Of Maryland - Eastern Shore,Maryland,3542365,5476295,9553000,18571660,0
CT,00141600,University Of Bridgeport,Connecticut,3271938,5533358,9724000,18529296,0
PR,02505400,Atlantic University College,Puerto Rico,3392323,5519097,9614000,18525420,0
PR,02282700,Inter American University Of Puerto Rico - Guayama Campus,Puerto Rico,3353951,5534682,9589000,18477633,0
LA,00203200,Xavier University Of Louisiana,Louisiana,3227606,5542343,9670000,18439949,0
OH,00727500,Eastern Gateway Community College,Ohio,928466,6354688,11129000,18412154,0
CA,00448100,Ohlone College,California,2555988,5652458,10123000,18331446,0
MA,00222500,Wentworth Institute Of Technology,Massachusetts,3469571,5314247,9539000,18322818,116142000
NC,00290700,University Of North Carolina Asheville,North Carolina,3359493,5428515,9499000,18287008,0
CO,00758200,Aims Community College,Colorado,2541187,5693412,10034000,18268599,0
TX,00666100,Angelina College,Texas,2612956,5694082,9961000,18268038,0
IL,00172800,Morton College,Illinois,2532643,5709962,10014000,18256605,0
TX,00362800,Texarkana College,Texas,2568337,5694732,9946000,18209069,0
KY,00195500,Berea College,Kentucky,3516276,5326942,9337000,18180218,1218740000
MN,01049100,Hennepin Technical College,Minnesota,2654457,5636807,9882000,18173264,0
AZ,00107200,Cochise College,Arizona,3163235,5418622,9586000,18167857,0
LA,00768600,Southern University At Shreveport - Bossier City,Louisiana,2595115,5665245,9852000,18112360,0
CA,00128200,San Jose City College,California,2274964,5691504,10144000,18110468,0
GA,01099700,East Georgia State College,Georgia,2879553,5552828,9657000,18089381,0
CA,00113300,California Lutheran University,California,3451376,5298324,9315000,18064700,108602000
FL,00153100,Stetson University,Florida,3578583,5217973,9256000,18052556,255416000
PA,00331800,Clarion University Of Pennsylvania,Pennsylvania,3224275,5388310,9436000,18048585,0
NY,00270500,College Of Saint Rose,New York,3475163,5285743,9263000,18023906,0
MO,00248200,Maryville University Of Saint Louis,Missouri,3144097,5370742,9494000,18008839,0
PA,00328900,Lehigh University,Pennsylvania,3616135,5150737,9206000,17972872,1411641000
NC,00298500,Wingate University,North Carolina,3526458,5245491,9189000,17960949,0
MO,00245900,Crowder College,Missouri,2638696,5563380,9748000,17950076,0
CA,00132600,Santa Clara University,California,3542678,5143956,9242000,17928634,1019760000
TX,04242100,University Of North Texas At Dallas,Texas,3036810,5421911,9454000,17912721,0
AZ,00830400,Scottsdale Community College,Arizona,2386925,5584623,9933000,17904548,0
MN,00237300,Rochester Community And Technical College,Minnesota,2629500,5542245,9711000,17882745,0
CA,00118500,College Of The Redwoods,California,2504489,5589825,9784000,17878314,0
MO,02530600,Saint Charles Community College,Missouri,2682474,5488788,9694000,17865262,0
CT,02244900,Goodwin University,Connecticut,2365797,5191240,10288000,17845037,0
NE,02099500,Central Community College,Nebraska,1890454,4636930,8176000,14703384,0
AL,00102800,Miles College,Alabama,3257934,5320726,9211000,17789660,0
KS,00549800,Wichita State University Campus Of Applied Sciences And Technology,Kansas,2383798,5577556,9809000,17770354,0
NY,00276500,Marist College,New York,3344611,5195563,9219000,17759174,0
MD,00206400,College Of Southern Maryland,Maryland,2579022,5480447,9683000,17742469,0
MS,00241300,Meridian Community College,Mississippi,2940110,5382355,9402000,17724465,0
MA,00217200,Mount Wachusett Community College,Massachusetts,2554747,5520672,9634000,17709419,0
GA,00562200,Georgia Piedmont Technical College,Georgia,2699452,5465270,9522000,17686722,0
IL,00176700,Benedictine University,Illinois,3297892,5212121,9176000,17686013,0
CA,00704700,Los Angeles Southwest College,California,2222854,5686223,9755000,17664077,0
MA,00221100,Springfield College,Massachusetts,3458881,5146652,9041000,17646533,77932000
PA,00332300,Lock Haven University Of Pennsylvania,Pennsylvania,3395845,5183846,9060000,17639691,0
CA,00124300,Mount Saint Mary'S University,California,3135747,5279211,9199000,17613958,0
NV,04114300,Nevada State College,Nevada,2755743,5390156,9445000,17590899,0
ID,00161900,College Of Southern Idaho,Idaho,2076917,5569456,9878000,17524373,0
AL,00573300,Bevill State Community College,Alabama,2642839,5413481,9466000,17522320,0
MO,00249500,Truman State University,Missouri,3345344,5119742,9038000,17503086,0
NC,00294900,University Of Mount Olive,North Carolina,3337015,5154411,8990000,17481426,0
CA,00132200,University Of Redlands,California,3388020,5125485,8960000,17473505,182278000
UT,00367900,Snow College,Utah,2478311,5443723,9550000,17472034,0
PA,00335700,Point Park University,Pennsylvania,3193085,5185309,9085000,17463394,0
CT,00976500,Three Rivers Community College,Connecticut,2253229,5525543,9646000,17424772,0
IN,00181500,Indiana University - Northwest,Indiana,2947212,5265615,9210000,17422827,0
CO,00134600,Arapahoe Community College,Colorado,2079610,5512598,9808000,17400208,0
PA,00335900,Robert Morris University,Pennsylvania,3326878,5091859,8980000,17398737,37013000
OH,00301400,Baldwin Wallace University,Ohio,3370528,5075637,8900000,17346165,179533000
PA,00339900,York College Of Pennsylvania,Pennsylvania,3283784,5089255,8951000,17324039,0
PR,03112100,Dewey University,Puerto Rico,3138599,5187169,8998000,17323768,0
FL,02305800,Florida Career College,Florida,17303589,0,0,17303589,0
KY,00527100,Southcentral Kentucky Community And Technical College,Kentucky,2424487,5410058,9461000,17295545,0
MO,00249100,Moberly Area Community College,Missouri,2410386,5357897,9390000,17158283,0
OR,00487800,Clackamas Community College,Oregon,1724926,5558561,9864000,17147487,0
VA,00371900,Longwood University,Virginia,3220578,5039427,8881000,17141005,71363000
NH,00257300,Dartmouth College,New Hampshire,3429350,4920074,8780000,17129424,5731322000
SC,00344900,University Of South Carolina - Aiken,South Carolina,3065412,5107433,8929000,17101845,0
NC,00297300,Gaston College,North Carolina,2520848,5286161,9276000,17083009,0
MN,00233400,Augsburg University,Minnesota,3259242,5018026,8777000,17054268,50786000
OK,00315400,East Central University,Oklahoma,3066346,5075356,8875000,17016702,0
GA,00155800,College Of Coastal Georgia,Georgia,2811985,5167644,9024000,17003629,0
IL,00167600,Elmhurst College,Illinois,3320646,4964496,8694000,16979142,112339000
CO,00134800,Colorado School Of Mines,Colorado,3445115,4867096,8657000,16969211,289011000
MO,00246800,Jefferson College,Missouri,2610155,5214046,9130000,16954201,134923000
GA,00560100,Albany Technical College,Georgia,2451149,5281805,9185000,16917954,0
HI,00161100,University Of Hawaii At Hilo,Hawaii,2994725,5063323,8848000,16906048,0
TX,00360400,Rice University,Texas,3433160,4823060,8644000,16900220,6481102000
CA,00120200,Gavilan College,California,2328197,5265223,9285000,16878420,0
NY,00678200,Genesee Community College,New York,2484880,5220960,9165000,16870840,0
PA,00743700,Pittsburgh Technical College,Pennsylvania,3296079,4947069,8599000,16842148,0
MS,00242400,Mississippi Valley State University,Mississippi,3079829,5002955,8694000,16776784,0
VA,01019800,Ecpi University,Virginia,16762368,0,0,16762368,0
FL,00151000,Northwest Florida State College,Florida,2530500,5151977,9069000,16751477,0
MS,00240200,Copiah-Lincoln Community College,Mississippi,3359493,4876965,8505000,16741458,0
OK,00964700,Oklahoma State University - Oklahoma City,Oklahoma,2300829,5237822,9199000,16737651,0
CA,04111300,West Hills College Lemoore,California,2260143,5260554,9204000,16724697,0
IL,00769100,Mchenry County College,Illinois,2254053,5209015,9252000,16715068,0
MS,00241600,Mississippi Delta Community College,Mississippi,2743944,5097200,8873000,16714144,0
NC,00291900,Davidson County Community College,North Carolina,2636381,5117842,8944000,16698223,0
NY,00277500,Molloy College,New York,2677888,5050913,8965000,16693801,40759000
MN,00233600,Bemidji State University,Minnesota,2813298,5037376,8841000,16691674,0
MO,00808000,State Fair Community College,Missouri,2466914,5177384,9045000,16689298,0
NY,00275800,Manhattan College,New York,3277749,4863451,8546000,16687200,107174000
NY,00678500,Schenectady County Community College,New York,2266692,5230881,9173000,16670573,0
OH,00759800,Hocking Technical College,Ohio,2402471,4437556,9826000,16666027,0
OK,00315700,Langston University,Oklahoma,3082441,4959009,8623000,16664450,0
MD,00207400,Hagerstown Community College,Maryland,2358314,5202597,9101000,16661911,0
PA,00329700,Mercyhurst University,Pennsylvania,3142547,4900955,8574000,16617502,0
NC,00297800,Wake Forest University,North Carolina,3404708,4711472,8497000,16613180,1375398000
MI,00676800,Mid Michigan College,Michigan,2641059,5077764,8873000,16591823,0
NE,00254200,Creighton University,Nebraska,3193341,4790999,8602000,16586340,587024000
PA,01017600,Westmoreland County Community College,Pennsylvania,2377450,5157844,9051000,16586294,0
LA,00546700,Sowela Technical Community College,Louisiana,2493383,5120697,8938000,16552080,0
TX,00360100,Paris Junior College,Texas,2287333,5177107,9086000,16550440,0
AR,00109700,Harding University,Arkansas,3252861,4801524,8490000,16544385,151411000
MD,00207500,Harford Community College,Maryland,2343664,5126050,9033000,16502714,0
CO,00135300,Fort Lewis College,Colorado,3038637,4891889,8553000,16483526,0
LA,00675600,Northshore Technical Community College,Louisiana,2051300,5242703,9180000,16474003,0
FL,00149000,Gulf Coast State College,Florida,2415469,5086482,8929000,16430951,0
VA,00865900,Lord Fairfax Community College,Virginia,2319604,5100496,9010000,16430100,0
OK,00398500,Oral Roberts University,Oklahoma,2933238,4896140,8574000,16403378,0
NC,00544900,Central Carolina Community College,North Carolina,2422099,5053041,8873000,16348140,0
OK,00316800,Rogers State University,Oklahoma,2586804,4985775,8699000,16271579,0
NY,00273700,Iona College,New York,3070913,4776064,8388000,16234977,159938000
WA,00379200,Skagit Valley College,Washington,2333763,5028156,8855000,16216919,0
MI,00232300,University Of Detroit Mercy,Michigan,3105323,4735579,8375000,16215902,69300000
MS,00241500,Mississippi College,Mississippi,3011426,4766371,8411000,16188797,0
CA,02119100,Mission College,California,1961952,5091885,9064000,16117837,0
KS,00192300,Hutchinson Community College,Kansas,2304535,5003358,8807000,16114893,0
FL,00150200,Lake Sumter State College,Florida,2306379,5012441,8790000,16108820,0
WI,00384000,Western Technical College,Wisconsin,2379444,4982783,8723000,16085227,0
TX,00362300,St. Mary'S University,Texas,3180524,4682898,8205000,16068422,196463000
CT,00763500,Capital Community College,Connecticut,2032022,5110446,8912000,16054468,0
NY,00285500,Suny College Of Technology At Canton,New York,2510929,4928910,8605000,16044839,0
OK,02306800,Platt College,Oklahoma,16031127,0,0,16031127,0
CT,00976400,Tunxis Community College,Connecticut,2185505,5023592,8790000,15999097,0
WA,00500600,Walla Walla Community College,Washington,2487718,4896390,8601000,15985108,0
NY,00286000,Adirondack Community College - Suny Office Of Community Colleges,New York,2558377,4876146,8532000,15966523,0
TX,00353700,Abilene Christian University,Texas,2982741,4691178,8274000,15947919,451731000
MD,00206800,Coppin State University,Maryland,2727906,4822740,8397000,15947646,0
AZ,02146600,South Mountain Community College,Arizona,2098614,5018347,8783000,15899961,0
IL,00174100,Olivet Nazarene University,Illinois,2972237,4678981,8226000,15877218,0
IL,00175000,Dominican University,Illinois,3025781,4672507,8168000,15866288,40445000
WI,00529400,Waukesha County Technical College,Wisconsin,1935258,5001888,8907000,15844146,0
TN,00348000,Bethel University,Tennessee,2121073,4986720,8720000,15827793,0
TX,00366300,Wayland Baptist University,Texas,2509726,4830767,8477000,15817493,0
NJ,00263900,Stevens Institute Of Technology,New Jersey,3121706,4477648,8178000,15777354,224304000
SC,00341900,Charleston Southern University,South Carolina,2880272,4678162,8199000,15757434,0
MA,00213300,Brandeis University,Massachusetts,3198465,4452458,8100000,15750923,1073526000
TX,00354600,Coastal Bend College,Texas,2133542,4928107,8661000,15722649,0
NC,00546300,Alamance Community College,North Carolina,2367785,4848030,8490000,15705815,0
CA,00126200,Point Loma Nazarene University,California,2913693,4628536,8162000,15704229,0
AR,01210500,National Park College,Arkansas,2285507,4894868,8515000,15695375,0
IL,01002000,Lewis And Clark Community College,Illinois,2062380,4918298,8706000,15686678,0
ID,00162300,North Idaho College,Idaho,2161877,4907648,8601000,15670525,0
WA,01036400,Whatcom Community College,Washington,2392620,4813638,8456000,15662258,0
LA,00201600,Loyola University New Orleans,Louisiana,2913258,4604038,8097000,15614296,0
MN,00234200,St. Catherine University,Minnesota,2645045,4698756,8253000,15596801,0
IN,00184200,Valparaiso University,Indiana,3107360,4509425,7931000,15547785,259042000
IN,00178800,Butler University,Indiana,3005303,4482000,7988000,15475303,0
FL,00149900,Altierus Career College,Florida,2524835,4730783,8205000,15460618,0
MS,00244700,William Carey University,Mississippi,2370656,4715985,8366000,15452641,0
HI,00454900,Leeward Community College,Hawaii,2067889,4835134,8543000,15446023,0
NY,00730400,Culinary Institute Of America,New York,2997253,4507864,7909000,15414117,138298000
TX,00353900,Alvin Community College,Texas,2277498,4736789,8388000,15402287,0
WA,00379100,Shoreline Community College,Washington,2438333,4668215,8266000,15372548,0
IL,00165400,City Colleges Of Chicago - Kennedy King College,Illinois,2144024,4811192,8414000,15369216,0
MI,00227600,Kellogg Community College,Michigan,1991422,4855538,8521000,15367960,0
MI,00229700,Muskegon Community College,Michigan,2247350,4751064,8332000,15330414,0
WV,00382200,Shepherd University,West Virginia,2679616,4591465,8052000,15323081,22145000
AK,00106300,University Of Alaska Fairbanks,Alaska,2066651,4781679,8471000,15319330,0
GA,00158200,Morehouse College,Georgia,2947819,4484089,7809000,15240908,0
MO,00246100,Drury University,Missouri,2470201,4648448,8120000,15238649,96517000
AZ,00107300,Eastern Arizona College,Arizona,2222272,4692651,8320000,15234923,0
PA,00331300,Widener University,Pennsylvania,2794641,4469255,7949000,15212896,94454000
VA,00374600,University Of Mary Washington,Virginia,2888681,4448919,7856000,15193600,0
TX,00357200,Trinity Valley Community College,Texas,1865240,4808492,8454000,15127732,0
IL,03083800,Heartland Community College,Illinois,2092953,4701213,8324000,15118166,0
MO,00247900,Lincoln University,Missouri,2565804,4575902,7973000,15114706,0
NH,00259000,Keene State College,New Hampshire,2997360,4391814,7719000,15108174,0
NC,00292700,Elon University,North Carolina,2989232,4333388,7770000,15092620,273429000
IL,00163800,Black Hawk College,Illinois,2172992,4663525,8230000,15066517,0
NY,00287000,Jefferson Community College,New York,2361051,4618540,8068000,15047591,0
GA,00159200,South Georgia State College,Georgia,2422737,4591608,7997000,15011345,0
GA,00525400,Lanier Technical College,Georgia,2122657,4680489,8201000,15004146,0
NJ,00259700,Bloomfield College,New Jersey,2851037,4441931,7705000,14997968,0
NY,00286900,Jamestown Community College,New York,2306997,4608853,8082000,14997850,0
CA,02559300,United Education Institute,California,14992982,0,0,14992982,0
TX,00359600,Odessa College,Texas,2118029,4719893,8126000,14963922,0
AZ,00822100,Universal Technical Institute,Arizona,14950305,0,0,14950305,0
MO,00471300,Three Rivers College,Missouri,2281288,4609172,8030000,14920460,0
CA,02242700,Berkeley City College,California,1844524,4706915,8362000,14913439,0
PA,00338400,University Of Scranton,Pennsylvania,2938777,4297505,7645000,14881282,209760000
WA,00378500,Pacific Lutheran University,Washington,2935869,4339965,7604000,14879834,0
IA,00189300,Upper Iowa University,Iowa,2210375,4587064,8048000,14845439,0
CA,00118100,College Of San Mateo,California,2042860,4571602,8217000,14831462,0
MS,00240400,East Central Community College,Mississippi,2606310,4456077,7763000,14825387,0
WA,00378800,Seattle Pacific University,Washington,2890475,4324878,7602000,14817353,0
NY,00285700,Suny College Of Technology At Delhi,New York,2436849,4511025,7867000,14814874,0
TN,00350200,Lincoln Memorial University,Tennessee,2657937,4377528,7741000,14776465,0
MS,00240100,Coahoma Community College,Mississippi,3136873,4236381,7353000,14726254,0
GA,00561900,North Georgia Technical College,Georgia,2114032,4588972,7992000,14695004,0
TX,00357600,Houston Baptist University,Texas,2615603,4386077,7689000,14690680,0
IL,00807600,John A. Logan College,Illinois,1452644,4729234,8501000,14682878,0
NY,00285600,Suny College Of Agriculture & Technology At Cobleskill,New York,2747860,4345324,7583000,14676184,0
MO,00246600,Harris - Stowe State University,Missouri,2513580,4447990,7712000,14673570,0
IA,00459500,Hawkeye Community College,Iowa,1769048,4673024,8230000,14672072,0
WA,00380400,Whitworth University,Washington,2840748,4295420,7526000,14662168,156048000
CA,00133800,West Valley College,California,2016079,4531612,8107000,14654691,0
IA,00731600,Western Iowa Tech Community College,Iowa,2023618,4573145,8036000,14632763,0
LA,00202600,Southern University At New Orleans,Louisiana,2481663,4428953,7714000,14624616,0
KY,00696000,Maysville Community And Technical College,Kentucky,1992396,4591401,8018000,14601797,0
AZ,01186400,Mohave Community College,Arizona,1933935,4605866,8050000,14589801,0
ME,00204300,Husson University,Maine,2674616,4321707,7574000,14570323,0
IN,00181400,Indiana University - Kokomo,Indiana,2505620,4384864,7668000,14558484,0
NY,00282000,Saint Francis College,New York,2673260,4322861,7549000,14545121,0
NY,00279800,Pratt Institute,New York,2831205,4188674,7518000,14537879,215667000
AR,00109100,Arkansas State University - Beebe,Arkansas,2141764,4498666,7872000,14512430,0
HI,00161300,Kapiolani Community College,Hawaii,2022941,4484284,7954000,14461225,0
NC,00293600,Johnson C Smith University,North Carolina,2718468,4307958,7432000,14458426,0
AL,00569700,Northwest - Shoals Community College,Alabama,2069470,4505213,7879000,14453683,0
PA,00336700,Saint Joseph'S University,Pennsylvania,2796324,4168820,7447000,14412144,294287000
TX,00357000,Grayson College,Texas,2157844,4451723,7796000,14405567,0
GA,01216500,Atlanta Metropolitan State College,Georgia,2149954,4464596,7767000,14381550,0
GA,00159400,Spelman College,Georgia,2804294,4189279,7384000,14377573,390462000
WA,00380100,Wenatchee Valley College,Washington,2466867,4320320,7585000,14372187,0
NE,00256600,Wayne State College,Nebraska,2521559,4301037,7547000,14369596,0
PA,00326600,Gannon University,Pennsylvania,2684679,4223568,7455000,14363247,65364000
VA,00370600,Christopher Newport University,Virginia,2893936,4128127,7326000,14348063,0
AL,00100300,Faulkner University,Alabama,2422978,4333744,7569000,14325722,15240000
MS,00240300,Delta State University,Mississippi,2524437,4272713,7524000,14321150,0
WA,00377800,Gonzaga University,Washington,2772507,4090622,7394000,14257129,294720000
KY,00197200,Lindsey Wilson College,Kentucky,2587859,4250842,7417000,14255701,0
CO,00136300,Regis University,Colorado,2448686,4210720,7494000,14153406,69773000
OK,00316200,Northern Oklahoma College,Oklahoma,1971017,4421809,7755000,14147826,0
FL,00152200,South Florida State College,Florida,2111445,4384283,7646000,14141728,0
AZ,03115000,Arizona College,Arizona,3665308,0,0,3665308,0
KY,00199600,Big Sandy Community And Technical College,Kentucky,1809773,4476232,7816000,14102005,0
FL,00789300,Flagler College,Florida,2708794,4137808,7247000,14093602,69919000
VT,01116700,Community College Of Vermont,Vermont,1480650,4566679,8031000,14078329,0
IL,00169400,Chicago State University,Illinois,2172014,4327173,7555000,14054187,0
MD,00210200,University Of Baltimore,Maryland,2325946,4240961,7476000,14042907,49878000
NY,00274800,Le Moyne College,New York,2709704,4105843,7215000,14030547,0
CA,00124700,Napa Valley College,California,2125082,4281704,7585000,13991786,0
MA,00212000,Merrimack College,Massachusetts,2646845,4085510,7245000,13977355,0
IA,00189100,University Of Dubuque,Iowa,2637393,4067317,7267000,13971710,160530000
TN,00349900,Lane College,Tennessee,2430978,4224957,7306000,13961935,0
MA,00223300,Worcester Polytechnic Institute,Massachusetts,2707195,4013416,7195000,13915611,528287000
WI,00539000,Blackhawk Technical College,Wisconsin,2201888,4269703,7428000,13899591,0
NY,00278800,Niagara University,New York,2711396,4034215,7103000,13848611,97242000
VA,00992800,Piedmont Virginia Community College,Virginia,1892438,4324347,7628000,13844785,0
KY,03034500,Owensboro Community & Technical College,Kentucky,1789723,4372164,7652000,13813887,0
TX,01323100,University Of Houston - Victoria,Texas,2233006,4184394,7374000,13791400,0
AL,00102400,University Of West Alabama,Alabama,2384585,4135471,7266000,13786056,0
GA,00551100,Coastal Pines Technical College,Georgia,1758137,4368692,7653000,13779829,0
NY,00282100,Saint John Fisher College,New York,2681804,3994698,7039000,13715502,0
MT,00253000,Montana State University - Billings,Montana,2193195,4180539,7339000,13712734,0
NY,00288300,Utica College,New York,2388832,4099539,7224000,13712371,24796000
NC,00933600,Johnston Community College,North Carolina,2258380,4152736,7290000,13701116,0
LA,00201200,Louisiana State University At Eunice,Louisiana,2060199,4236259,7391000,13687458,0
FL,00151500,Rollins College,Florida,2692112,3898553,7085000,13675665,379841000
AL,00100400,University Of Montevallo,Alabama,2560001,4041651,7060000,13661652,0
TN,00348600,Lipscomb University,Tennessee,2582024,3982698,7074000,13638722,0
RI,00341000,Roger Williams University,Rhode Island,2629911,3959064,7041000,13629975,86049000
MA,00214600,Emerson College,Massachusetts,2734314,3921763,6964000,13620077,0
IA,00840300,Indian Hills Community College,Iowa,2199657,4137403,7264000,13601060,0
OK,00318500,University Of Tulsa (The),Oklahoma,2645588,3954569,7000000,13600157,0
NC,00291600,Chowan University,North Carolina,2614325,4018655,6964000,13596980,0
MS,00243600,Southwest Mississippi Community College,Mississippi,2320170,4117342,7158000,13595512,0
OK,00317900,Southeastern Oklahoma State University,Oklahoma,2118149,4153547,7287000,13558696,0
TX,04263600,Northeast Lakeview College,Texas,1343444,4407215,7799000,13549659,0
NC,00296100,Sandhills Community College,North Carolina,2033057,4181526,7335000,13549583,0
MD,00210700,Stevenson University,Maryland,2499743,4005614,7033000,13538357,0
NY,00678800,Tompkins Cortland Community College,New York,1845177,4215523,7470000,13530700,0
SC,00681500,Orangeburg - Calhoun Technical College,South Carolina,1996646,4204932,7325000,13526578,0
WI,00383900,Carthage College,Wisconsin,2668496,3851906,6990000,13510402,111496000
VA,00681900,Blue Ridge Community College,Virginia,1862031,4228308,7418000,13508339,0
MA,00222600,Western New England University,Massachusetts,2684604,3915648,6902000,13502252,56683000
KY,00527300,Gateway Community And Technical College,Kentucky,1797783,4249192,7444000,13490975,0
CA,00927200,Crafton Hills College,California,1933930,4149254,7390000,13473184,0
MA,00212400,Bentley University,Massachusetts,2665628,3883553,6918000,13467181,0
MN,00235400,Hamline University,Minnesota,2570227,3943823,6945000,13459050,100550000
MO,00250200,Southwest Baptist University,Missouri,2301587,4056193,7100000,13457780,0
MI,00230200,Northwestern Michigan College,Michigan,2124216,4118115,7197000,13439331,0
CA,02332800,Center For Employment Training,California,2223425,4089677,7122000,13435102,0
OR,00319400,George Fox University,Oregon,2589776,3921838,6923000,13434614,0
NY,00281600,Siena College,New York,2620637,3899632,6853000,13373269,0
MD,00207100,Frederick Community College,Maryland,1851890,4147691,7351000,13350581,0
MD,02073900,Wor-Wic Community College,Maryland,1860894,4183209,7303000,13347103,0
RI,00340600,Providence College,Rhode Island,2699566,3830403,6812000,13341969,234228000
IN,00793800,Lincoln College Of Technology,Indiana,13341054,0,0,13341054,0
NY,00269900,Clarkson University,New York,2590707,3872273,6845000,13307980,201698000
OR,00322400,University Of Portland,Oregon,2672004,3830681,6796000,13298685,0
MO,00250000,College Of The Ozarks,Missouri,2518807,3934298,6838000,13291105,476624000
OR,00321100,Oregon Institute Of Technology,Oregon,1807273,4145176,7337000,13289449,0
CA,00126700,Merritt College,California,1497283,4233724,7541000,13272007,0
PA,00322900,Albright College,Pennsylvania,2569568,3863482,6801000,13234050,77103000
MI,00224100,Calvin University,Michigan,2639029,3829529,6764000,13232558,176538000
MD,00207800,Loyola University Maryland,Maryland,2612460,3800541,6789000,13202001,0
FL,00884900,Palm Beach Atlantic University,Florida,2363047,3920083,6904000,13187130,85236000
NC,00294200,Livingstone College,North Carolina,2503063,3910216,6771000,13184279,0
MN,00575700,Lake Superior College,Minnesota,1757151,4132002,7292000,13181153,0
PA,00339400,Wilkes University,Pennsylvania,2403446,3896453,6879000,13178899,54044000
NC,00293300,High Point University,North Carolina,2605940,3731389,6826000,13163329,0
TN,00399900,Cleveland State Community College,Tennessee,1970716,4067122,7121000,13158838,0
VA,00498800,Central Virginia Community College,Virginia,1817818,4111607,7215000,13144425,0
MN,00553700,South Central College,Minnesota,1873482,4096933,7173000,13143415,0
LA,00200400,Dillard University,Louisiana,2442809,3903275,6762000,13108084,0
AL,00103100,Northeast Alabama Community College,Alabama,1901781,4075756,7117000,13094537,0
ME,00527600,Central Maine Community College,Maine,1882719,4059822,7081000,13023541,0
TX,00357300,Hill College,Texas,1336557,4231488,7454000,13022045,0
OK,00317200,Oklahoma State University Institute Of Technology - Okmulgee,Oklahoma,2248014,3918800,6839000,13005814,0
MS,00239700,Belhaven University,Mississippi,2204818,3919675,6880000,13004493,0
TN,00351800,Southern Adventist University,Tennessee,2443809,3826927,6704000,12974736,46402000
CA,00130200,Saint Mary'S College Of California,California,2525736,3766129,6662000,12953865,181313000
MO,00245300,Central Methodist University,Missouri,1766287,3984117,7192000,12942404,0
MN,00905800,Bethel University,Minnesota,2452828,3803833,6679000,12935661,0
IA,00458700,Northeast Iowa Community College,Iowa,1835580,4009002,7056000,12900582,0
TX,00993000,University Of Texas Of The Permian Basin,Texas,1840016,4007546,7050000,12897562,0
IL,00173500,North Park University,Illinois,2332872,3834812,6712000,12879684,0
NY,00290300,Yeshiva University,New York,2479795,3711922,6680000,12871717,665001000
LA,00201100,Louisiana State University At Alexandria,Louisiana,1998555,3959812,6911000,12869367,0
PA,00323500,Arcadia University,Pennsylvania,2563133,3728760,6577000,12868893,82645000
SC,00342300,"Citadel, The Military College Of South Carolina",South Carolina,2499158,3698438,6663000,12860596,0
KY,00199000,Ashland Community And Technical College,Kentucky,1897125,3997808,6961000,12855933,0
VA,03091300,Regent University,Virginia,1567327,4071730,7153000,12792057,0
OH,00302300,Capital University,Ohio,2486868,3710353,6534000,12731221,106663000
OH,01104600,Central Ohio Technical College,Ohio,1667250,4014980,7042000,12724230,0
CA,00130900,Taft College,California,1122910,4175867,7421000,12719777,0
GA,00561700,South Georgia Technical College,Georgia,1870108,3954455,6883000,12707563,0
MI,00231000,St. Clair County Community College,Michigan,1909478,3923106,6873000,12705584,0
PA,00328300,Lackawanna College,Pennsylvania,1885348,3937122,6882000,12704470,0
NC,00295100,North Carolina Wesleyan College,North Carolina,2177353,3837299,6674000,12688652,0
MA,00217100,Massachusetts Bay Community College,Massachusetts,1775751,3944066,6968000,12687817,0
TX,00709600,College Of The Mainland,Texas,1767883,3950300,6957000,12675183,0
TX,00979700,Midland College,Texas,1673002,3920402,7073000,12666404,0
ID,00162100,Lewis-Clark State College,Idaho,1979771,3877118,6799000,12655889,0
IL,00173400,North Central College,Illinois,2410282,3713512,6517000,12640794,0
WA,00970400,North Seattle College,Washington,1795310,3896932,6946000,12638242,0
FL,00149500,Jacksonville University,Florida,2208846,3764301,6641000,12614147,46743000
MN,00525200,Ridgewater College,Minnesota,1950916,3860185,6761000,12572101,0
NY,00286300,Corning Community College - Suny Office Of Community Colleges,New York,1937448,3844791,6752000,12534239,0
WI,00538700,Northcentral Technical College,Wisconsin,1482377,3991652,7055000,12529029,0
MS,00242200,Mississippi University For Women,Mississippi,2188061,3763183,6566000,12517244,0
PA,00324000,Butler County Community College,Pennsylvania,1882832,3855833,6762000,12500665,0
TX,00355300,Cisco College,Texas,1817547,3864761,6771000,12453308,0
TX,00356000,Dallas Baptist University,Texas,2198677,3689859,6525000,12413536,0
AL,00573400,H. Councill Trenholm State Community College,Alabama,1892834,3837980,6679000,12409814,0
NC,00546400,Richmond Community College,North Carolina,1993968,3796431,6618000,12408399,0
KY,00195400,Bellarmine University,Kentucky,2469277,3570531,6298000,12337808,66331000
IA,00186000,Drake University,Iowa,2224225,3636645,6470000,12330870,226155000
HI,00160600,Brigham Young University - Hawaii,Hawaii,2306881,3626535,6397000,12330416,0
NJ,00261000,Felician University,New Jersey,2243499,3667867,6395000,12306366,0
NY,00277700,Medaille College,New York,2028538,3721180,6510000,12259718,0
LA,02166100,Elaine P. Nunez Community College,Louisiana,1561099,3892436,6782000,12235535,0
OH,00302500,Cedarville University,Ohio,2294323,3591516,6346000,12231839,36485000
MO,00248600,Mineral Area College,Missouri,1986137,3722656,6504000,12212793,0
LA,00201300,Louisiana State University In Shreveport,Louisiana,1825886,3754151,6628000,12208037,0
VA,00374400,University Of Richmond,Virginia,2425545,3524203,6256000,12205748,2517969000
NC,00292600,Elizabeth City State University,North Carolina,2130978,3679189,6391000,12201167,0
WA,00970600,South Seattle College,Washington,1861609,3692544,6629000,12183153,0
KY,00199800,Southeast Kentucky Community And Technical College,Kentucky,1616993,3839470,6717000,12173463,0
NC,00298000,Wayne Community College,North Carolina,1871243,3744411,6553000,12168654,0
PA,00325900,Eastern University,Pennsylvania,2228030,3602009,6325000,12155039,0
MA,01193000,Roxbury Community College,Massachusetts,1677144,3819450,6649000,12145594,0
FL,00148800,Florida Southern College,Florida,2291992,3566789,6280000,12138781,79136000
MH,03022400,College Of The Marshall Islands,Marshall Islands,1956673,3719492,6438000,12114165,0
CA,02120700,San Joaquin Valley College,California,12104128,0,0,12104128,0
NY,00270300,College Of Mount Saint Vincent,New York,2592348,3459827,6034000,12086175,0
WV,00382300,West Liberty University,West Virginia,2246663,3578510,6260000,12085173,0
NE,01166700,Northeast Community College,Nebraska,1729207,3746465,6605000,12080672,0
CO,00450600,Colorado Mountain College,Colorado,1694667,3735220,6647000,12076887,0
NC,00294600,Methodist University,North Carolina,1925342,2957602,5175000,10057944,0
NH,00258100,Nhti - Concord'S Community College,New Hampshire,1806576,3714959,6544000,12065535,0
CA,00121500,La Sierra University,California,2144179,3606411,6301000,12051590,0
MN,00974000,Inver Hills Community College,Minnesota,1718868,3737337,6585000,12041205,0
CA,04143800,Woodland Community College,California,1623074,3766737,6640000,12029811,0
SC,01005600,Aiken Technical College,South Carolina,1824100,3718101,6480000,12022201,0
NC,00483500,Caldwell Community College & Technical Institute,North Carolina,1753469,3728354,6538000,12019823,0
IL,00172400,Millikin University,Illinois,2299043,3534156,6172000,12005199,106893000
CA,00111900,Barstow Community College,California,1556808,3808377,6639000,12004185,0
TX,03627300,Lamar Institute Of Technology,Texas,1836301,3711898,6453000,12001199,0
WA,00378200,Lower Columbia College,Washington,1810047,3702313,6473000,11985360,0
NY,00266500,Vaughn College Of Aeronautics And Technology,New York,2140817,3593590,6248000,11982407,24465000
NC,00296200,Shaw University,North Carolina,2258545,3540428,6140000,11938973,0
OH,00304500,University Of Findlay (The),Ohio,2250867,3488769,6194000,11933636,0
DC,00143700,Catholic University Of America (The),District of Columbia,2374572,3406832,6148000,11929404,0
WI,00383800,Carroll University,Wisconsin,2437429,3503766,6181000,12122195,0
NY,00268100,Canisius College,New York,2334830,3470452,6108000,11913282,129201000
TN,00348100,Carson - Newman University,Tennessee,2295168,3490978,6121000,11907146,0
MN,00234300,College Of Saint Scholastica,Minnesota,2274924,3476779,6137000,11888703,0
MO,01250000,Ranken Technical College,Missouri,2185927,3523730,6137000,11846657,0
WA,00499900,Bellingham Technical College,Washington,1833051,3642353,6361000,11836404,0
OK,00317600,Carl Albert State College,Oklahoma,1880688,3626361,6309000,11816049,0
CT,00138500,Fairfield University,Connecticut,2137358,3463328,6206000,11806686,374896000
AL,00103600,Samford University,Alabama,2381353,3353321,6072000,11806674,0
CA,03698300,West Coast University,California,11797821,0,0,11797821,0
NY,00286100,Cayuga Community College - Suny Office Of Community College,New York,1497604,3718340,6559000,11774944,0
OR,00321200,Pacific University,Oregon,2323471,3403723,6046000,11773194,0
MN,00237500,Southwest Minnesota State University,Minnesota,1644234,3629923,6487000,11761157,0
OK,00315300,Connors State College,Oklahoma,1785542,3639242,6336000,11760784,0
MA,00216000,Lesley University,Massachusetts,1997859,3513514,6244000,11755373,187972000
VA,00522300,New River Community College,Virginia,1658163,3654725,6439000,11751888,0
LA,03789400,River Parishes Community College,Louisiana,963683,3913055,6859000,11735738,0
NY,01167800,State University Of New York Polytechnic Institute,New York,2129510,3490152,6116000,11735662,0
CA,00111600,Art Center College Of Design,California,2168231,3469092,6091000,11728323,0
TX,00366200,Victoria College,Texas,1680905,3650333,6396000,11727238,0
VA,00376600,Virginia Union University,Virginia,2251677,3451922,6021000,11724599,0
NE,00974300,Bellevue University,Nebraska,1169139,3824467,6710000,11703606,0
VA,00866100,Southside Virginia Community College,Virginia,1677846,3641711,6382000,11701557,0
AR,00524500,University Of Arkansas Community College At Morrilton,Arkansas,1861056,3589050,6247000,11697106,0
PR,00501900,Universidad Adventista De Las Antillas,Puerto Rico,2178276,3474235,6026000,11678511,0
WA,01043400,Renton Technical College,Washington,1717551,3599677,6356000,11673228,0
TX,00363800,Texas College,Texas,2358852,3406198,5902000,11667050,0
VT,00368800,Northern Vermont University,Vermont,1932341,3530182,6161000,11623523,0
VA,00726000,Southwest Virginia Community College,Virginia,1671535,3623306,6309000,11603841,0
VT,00369200,Norwich University,Vermont,2004614,3477779,6121000,11603393,0
WI,00386800,Milwaukee School Of Engineering,Wisconsin,2285262,3379921,5936000,11601183,0
TX,01006000,Vernon College,Texas,1381106,3712194,6489000,11582300,0
OH,00305000,John Carroll University,Ohio,2224405,3380237,5976000,11580642,0
TX,00362500,Sul Ross State University,Texas,1779991,3571688,6224000,11575679,0
OK,00316000,Northeastern Oklahoma A & M College,Oklahoma,1934724,3512456,6119000,11566180,0
AL,00104600,Talladega College,Alabama,2069544,3454443,5987000,11510987,0
TX,00359800,Our Lady Of The Lake University,Texas,2078279,3418669,5998000,11494948,0
PR,01056700,Colegio Universitario De San Juan,Puerto Rico,2002902,3471401,6012000,11486303,0
VA,00375800,Danville Community College,Virginia,1604222,3591706,6289000,11484928,0
OH,00311000,Otterbein University,Ohio,2255286,3344331,5879000,11478617,101386000
SC,00345000,University Of South Carolina - Beaufort,South Carolina,2075254,3423472,5972000,11470726,0
CA,02110800,California College San Diego,California,2281144,3504173,5668000,11453317,0
TX,00365400,University Of Saint Thomas,Texas,1984472,3430711,6036000,11451183,0
SC,00341800,Anderson University,South Carolina,2092286,3389001,5968000,11449287,0
ME,00204000,University Of Maine - Farmington,Maine,2158052,3371441,5885000,11414493,0
NY,00479900,Monroe College,New York,11408077,0,0,11408077,0
MN,00869400,Rasmussen College,Minnesota,11388948,0,0,11388948,0
TX,02572000,Vista College,Texas,11351349,0,0,11351349,0
MN,00233900,Central Lakes College,Minnesota,1658191,3507873,6185000,11351064,0
CT,00142400,Wesleyan University,Connecticut,2257086,3252068,5837000,11346154,1004806000
AR,00110300,Philander Smith College,Arkansas,2143674,3363217,5820000,11326891,0
MA,00214800,Endicott College,Massachusetts,2063007,3324451,5921000,11308458,95673000
SC,00344100,North Greenville University,South Carolina,2143104,3311855,5806000,11260959,0
FL,00148600,Florida Memorial University,Florida,2154643,3325368,5770000,11250011,0
PA,00327500,Holy Family University,Pennsylvania,2023957,3344930,5881000,11249887,0
CO,00559600,Emily Griffith Technical College,Colorado,1828725,3372652,6045000,11246377,0
OH,00303000,Ohio Christian University,Ohio,1748170,3453072,6022000,11223242,0
VA,00372400,Marymount University,Virginia,2074937,3297419,5826000,11198356,0
MO,00886200,East Central College,Missouri,1651321,3471107,6066000,11188428,0
IL,00175300,School Of The Art Institute Of Chicago,Illinois,2167774,3250859,5763000,11181633,0
OH,00308900,Ohio Northern University,Ohio,2189709,3255742,5733000,11178451,160300000
KS,00193700,Ottawa University,Kansas,1667633,3455105,6044000,11166738,0
OH,00308300,University Of Mount Union,Ohio,2209587,3235680,5714000,11159267,140318000
CA,00117800,College Of Marin,California,1347945,3526729,6281000,11155674,0
KY,00199400,Hopkinsville Community College,Kentucky,1399325,3556627,6197000,11152952,0
CA,00129300,Vanguard University Of Southern California,California,1879831,3373721,5899000,11152552,0
GA,03030000,Ogeechee Technical College,Georgia,1622353,3469544,6046000,11137897,0
IL,00769000,Kankakee Community College,Illinois,1267153,3574930,6278000,11120083,0
WV,00381000,Concord University,West Virginia,2057014,3299115,5763000,11119129,0
IN,00183900,Trine University,Indiana,1800977,3358765,5958000,11117742,0
NY,00266800,Alfred University,New York,2093987,3260034,5739000,11093021,138254000
TX,00357400,Howard County Junior College District,Texas,1454607,3485538,6129000,11069145,0
PA,00336900,Susquehanna University,Pennsylvania,2191211,3214295,5663000,11068506,173197000
HI,00727900,Hawaii Pacific University,Hawaii,1879700,3322635,5866000,11068335,0
PA,00323300,Alvernia University,Pennsylvania,1983784,3298556,5785000,11067340,0
ME,00676000,University Of Maine - Augusta,Maine,1351526,3537103,6178000,11066629,0
MA,00220900,Smith College,Massachusetts,2119895,3123009,5513000,10755904,1913253000
IL,00976700,Olive-Harvey College,Illinois,1429900,3488900,6127000,11045800,0
WI,01182400,Wisconsin Indianhead Technical College,Wisconsin,1505393,3454455,6049000,11008848,0
DC,00146000,Trinity Washington University,District of Columbia,1960751,3299710,5742000,11002461,0
GA,00157300,Georgia Southwestern State University,Georgia,1848045,3327789,5826000,11001834,0
PR,03544300,Atenas College,Puerto Rico,2067059,3263200,5650000,10980259,0
WA,00530600,Bates Technical College,Washington,1684098,3335482,5943000,10962580,0
MA,00211400,American International College,Massachusetts,1970878,3253225,5730000,10954103,0
MN,00238200,Saint Olaf College,Minnesota,2167063,3177701,5603000,10947764,0
MI,00227700,Lake Michigan College,Michigan,1133204,3566805,6245000,10945009,0
TN,00352800,Union University,Tennessee,1984881,3240309,5712000,10937190,0
TX,01067400,Texas Tech University Health Sciences Center,Texas,2217206,3124943,5590000,10932149,0
NY,00277900,Nazareth College Of Rochester,New York,2117252,3190890,5624000,10932142,71318000
WV,00382600,West Virginia State University,West Virginia,1650103,3356005,5908000,10914108,0
MA,00220800,Simmons University,Massachusetts,2222441,3107695,5540000,10870136,195840000
MI,00227300,Hope College,Michigan,2163878,3146684,5558000,10868562,232249000
WV,00382800,West Virginia University - Parkersburg,West Virginia,1753087,3316392,5786000,10855479,0
RI,00340200,Bryant University,Rhode Island,2160764,3126451,5562000,10849215,184753000
CA,01167200,Mendocino College,California,1309837,3442731,6073000,10825568,0
IL,00170100,Kaskaskia College,Illinois,1449286,3394076,5982000,10825362,0
PR,01194100,American University Of Puerto Rico,Puerto Rico,1861065,3275786,5673000,10809851,0
MO,00754000,Missouri Baptist University,Missouri,1567808,3332982,5902000,10802790,0
IL,00768400,Kishwaukee College,Illinois,1545526,3355410,5901000,10801936,0
WY,00925900,Laramie County Community College,Wyoming,1502654,3360314,5932000,10794968,0
IA,00188900,Saint Ambrose University,Iowa,2054932,3163850,5573000,10791782,0
FL,00150100,Florida Gateway College,Florida,1498341,3377996,5915000,10791337,17831000
MP,03033000,Northern Marianas College,Mariana Islands,1839331,3274565,5675000,10788896,0
NJ,00259800,Caldwell University,New Jersey,2028129,3184209,5567000,10779338,0
NY,00757200,American Musical & Dramatic Academy,New York,2278035,3091878,5389000,10758913,0
LA,00548900,Central Louisiana Technical Community College,Louisiana,1462721,3372323,5911000,10746044,0
WI,00538000,Mid-State Technical College,Wisconsin,1528012,3350674,5860000,10738686,0
NH,00257900,New England College,New Hampshire,1554133,3460812,5676000,10690945,0
AL,01218200,Chattahoochee Valley Community College,Alabama,1645716,3294681,5734000,10674397,0
PA,00329800,Messiah College,Pennsylvania,2106740,3089265,5460000,10656005,141904000
NC,00861200,Robeson Community College,North Carolina,1637622,3285022,5722000,10644644,0
VA,00373700,Shenandoah University,Virginia,2040202,3089197,5503000,10632399,68105000
TN,00683500,Dyersburg State Community College,Tennessee,1495222,3316095,5797000,10608317,0
NC,00294100,Lenoir-Rhyne University,North Carolina,1941090,3141073,5523000,10605163,0
MA,00216800,Cape Cod Community College,Massachusetts,1440010,3325139,5837000,10602149,0
IL,00933300,University Of Illinois At Springfield,Illinois,1731887,3201018,5637000,10569905,0
OH,00312100,Tiffin University,Ohio,1977210,3108766,5453000,10538976,0
WV,03957300,Blue Ridge Community And Technical College,West Virginia,1185596,3363953,5989000,10538549,0
IN,00183200,University Of Saint Francis,Indiana,1891129,3141501,5499000,10531630,0
WA,00377200,Centralia College,Washington,1477765,3276103,5767000,10520868,0
PA,00330100,Moravian College,Pennsylvania,2025895,3071936,5401000,10498831,0
IL,00163300,Augustana College,Illinois,2091818,3038896,5347000,10477714,172846000
MA,00214300,Curry College,Massachusetts,1934414,3097788,5445000,10477202,103667000
IL,01087900,Richland Community College,Illinois,1365509,3306518,5795000,10467027,0
OK,00531100,Tulsa Technology Center School District No. 18,Oklahoma,1717200,3155311,5594000,10466511,0
PA,00329600,Marywood University,Pennsylvania,2020450,3048348,5366000,10434798,40574000
MD,00210400,"University Of Maryland, Baltimore",Maryland,2077903,2965115,5384000,10427018,0
TX,00363700,Jarvis Christian College,Texas,1888040,3124313,5410000,10422353,0
TX,00357100,Hardin-Simmons University,Texas,1934006,3072013,5385000,10391019,194708000
MN,00234700,Concordia University - Saint Paul,Minnesota,1588736,3186977,5604000,10379713,0
NY,00274400,Keuka College,New York,1981704,3051019,5325000,10357723,0
VA,00372000,University Of Lynchburg,Virginia,1975980,3024446,5335000,10335426,112879000
PA,00398600,Desales University,Pennsylvania,1846942,3064499,5418000,10329441,91841000
TN,00348500,Cumberland University,Tennessee,1920642,3052125,5353000,10325767,0
CA,04161800,Brandman University,California,1196618,3322586,5801000,10320204,0
IL,00170500,Illinois Valley Community College,Illinois,1373121,3234228,5690000,10297349,0
VI,00394600,University Of The Virgin Islands,Virgin Islands,1713737,3121047,5446000,10280784,71684000
NY,00267100,Bard College,New York,2064786,2969456,5227000,10261242,0
PA,00332400,Mansfield University Of Pennsylvania,Pennsylvania,1932117,3032041,5279000,10243158,0
IL,00165700,Midwestern University,Illinois,2255126,2802472,5180000,10237598,170498000
TX,00364500,Texas Wesleyan University,Texas,1857910,3043923,5334000,10235833,59523000
VT,00368300,Castleton University,Vermont,1756834,3074340,5400000,10231174,0
SD,00776400,Southeast Technical Institute,South Dakota,1770458,3069293,5389000,10228751,0
MN,00235300,Gustavus Adolphus College,Minnesota,2036930,2975740,5215000,10227670,203365000
NM,00266400,Western New Mexico University,New Mexico,1551426,3145154,5512000,10208580,0
IL,00178100,Wheaton College,Illinois,2023744,2958197,5225000,10206941,0
GU,01536100,Guam Community College,Guam,1149350,3303441,5747000,10199791,0
NC,00292900,Gardner - Webb University,North Carolina,1825407,3022376,5352000,10199783,0
LA,00576100,L. E. Fletcher Technical Community College,Louisiana,1375120,3215401,5608000,10198521,0
NM,00265300,New Mexico Highlands University,New Mexico,1699974,3085628,5407000,10192602,0
WA,00938700,Perry Technical Institute,Washington,1967635,2986793,5234000,10188428,0
TN,00352600,Trevecca Nazarene University,Tennessee,1718898,3063682,5401000,10183580,0
IL,00172700,Moody Bible Institute,Illinois,1848490,3020458,5296000,10164948,0
FL,00150500,Lynn University,Florida,1935875,2968610,5244000,10148485,0
VA,00375100,Patrick Henry Community College,Virginia,1483723,3155816,5507000,10146539,0
PA,00327200,Harcum College,Pennsylvania,1774344,3057654,5310000,10141998,0
NY,00279000,Nyack College,New York,1773064,3041063,5318000,10132127,0
OK,00316400,Oklahoma Baptist University,Oklahoma,1934138,2980341,5209000,10123479,130508000
TX,00495100,University Of Texas Health Science Center At Houston,Texas,1995703,2893112,5228000,10116815,0
PA,00328200,Kings College,Pennsylvania,1968517,2948842,5192000,10109359,0
VT,00369100,Middlebury College,Vermont,1862094,2947241,5283000,10092335,1157786000
NC,00679900,Craven Community College,North Carolina,1509343,3112898,5451000,10073241,0
WA,00537300,Lake Washington Institute Of Technology,Washington,1558088,3070557,5440000,10068645,0
NY,00280800,Daemen College,New York,1872946,2971689,5221000,10065635,0
PA,00398800,Neumann University,Pennsylvania,1758118,3015010,5285000,10058128,0
NM,02357600,Navajo Technical University,New Mexico,1503703,3109240,5439000,10051943,0
IL,00174200,Illinois Eastern Community Colleges - Olney Central College,Illinois,737002,6578576,2723000,10038578,0
PA,00325200,Delaware Valley University,Pennsylvania,1867829,2963697,5203000,10034526,33623000
TX,02315400,Northeast Texas Community College,Texas,1140273,3231497,5655000,10026770,0
VA,00962900,Mountain Empire Community College,Virginia,1394924,3133357,5473000,10001281,0
SD,00345900,Black Hills State University,South Dakota,1514973,3069733,5415000,9999706,0
NY,00271200,D'Youville College,New York,1773370,2969354,5240000,9982724,0
TX,00360000,Panola College,Texas,1507332,3083051,5387000,9977383,0
MO,00246300,Evangel University,Missouri,1850723,2955736,5167000,9973459,0
OK,00314900,Southern Nazarene University,Oklahoma,1815175,2957714,5179000,9951889,0
AL,00898800,Lurleen B. Wallace Community College,Alabama,1546138,3063215,5342000,9951353,0
WI,00925600,Moraine Park Technical College,Wisconsin,1215286,3149222,5584000,9948508,0
IA,00186700,Grand View University,Iowa,1805328,2955616,5164000,9924944,25734000
NY,00286700,Suny Fulton-Montgomery Community College,New York,1635420,3014275,5268000,9917695,0
OH,00531300,North Central State College,Ohio,1410128,3087374,5415000,9912502,0
PA,00324100,Cabrini University,Pennsylvania,2005185,2866887,5026000,9898072,0
NY,00277800,Mount Saint Mary College,New York,1809886,2927444,5135000,9872330,5998000
CA,00672000,College Of Alameda,California,1049170,3172271,5642000,9863441,0
SD,00530900,Lake Area Technical Institute,South Dakota,1768161,2943424,5150000,9861585,0
MA,00213900,Clark University,Massachusetts,1940791,2852424,5055000,9848215,438767000
MA,00222400,Wellesley College,Massachusetts,1970468,2841471,5011000,9822939,2173415000
KY,00696200,Hazard Community And Technical College,Kentucky,1248333,3109690,5451000,9809023,0
IL,00166600,Concordia University,Illinois,1875573,3094265,5470000,10439838,0
MD,00205700,Allegany College Of Maryland,Maryland,1494165,3023670,5283000,9800835,0
NC,00990300,Vance - Granville Community College,North Carolina,1453645,3033363,5310000,9797008,0
NY,00478800,Herkimer County Community College - Suny Office Of Community Colleges,New York,1522074,3009187,5264000,9795261,0
VA,00709900,Virginia Highlands Community College,Virginia,1398769,3055930,5335000,9789699,0
MN,00238500,Northland Community And Technical College,Minnesota,1355409,3053777,5361000,9770186,0
NM,02278100,Santa Fe Community College,New Mexico,1219106,3085414,5457000,9761520,0
OH,00311600,University Of Rio Grande,Ohio,1717045,2931560,5112000,9760605,0
AR,02052200,Black River Technical College,Arkansas,1643629,2961823,5154000,9759452,0
CA,00134200,Whittier College,California,1879550,2866302,5011000,9756852,112868000
MN,00238000,Saint Mary'S University Of Minnesota,Minnesota,1661096,2884483,5163000,9708579,61788000
NC,00297000,Surry Community College,North Carolina,1433250,3021468,5245000,9699718,0
AR,04203400,Arkansas State University - Newport,Arkansas,1266638,3055614,5377000,9699252,0
IL,02185400,Saint Augustine College,Illinois,1496982,3001085,5201000,9699067,0
GA,00158800,Piedmont College,Georgia,1766322,2872263,5060000,9698585,0
MI,00231700,Southwestern Michigan College,Michigan,1522115,2956093,5166000,9644208,0
ME,00527700,Eastern Maine Community College,Maine,1426773,2974826,5230000,9631599,0
MA,00214100,College Of The Holy Cross,Massachusetts,1919146,2750691,4939000,9608837,785852000
NJ,00260800,Georgian Court University,New Jersey,1690335,2873205,5041000,9604540,54858000
NC,00855700,Nash Community College,North Carolina,1299061,3007699,5276000,9582760,0
OH,00313500,Walsh University,Ohio,1831514,2803207,4933000,9567721,0
MI,00231600,Siena Heights University,Michigan,1545879,2914880,5095000,9555759,0
CT,00803800,Middlesex Community College,Connecticut,1323379,2987020,5242000,9552399,0
WI,00383200,Alverno College,Wisconsin,1738517,2843337,4957000,9538854,0
PA,00323800,Bucknell University,Pennsylvania,1946454,2725476,4863000,9534930,866835000
TX,03170300,Texas A & M University - Texarkana,Texas,1525001,2916364,5093000,9534365,0
NC,00294700,Mitchell Community College,North Carolina,1393025,2950186,5181000,9524211,0
CA,03542400,Copper Mountain College,California,1372962,2973281,5176000,9522243,0
NY,00288000,Ulster County Community College,New York,1387075,2929602,5170000,9486677,0
FL,00147800,Edward Waters College,Florida,1361209,2936739,5183000,9480948,0
NY,00289500,Vassar College,New York,1835621,2768070,4871000,9474691,1117380000
CA,00121800,Loma Linda University,California,1777517,2743699,4927000,9448216,1076898000
FL,02362100,Full Sail University,Florida,9445834,0,0,9445834,0
WY,00392800,Casper College,Wyoming,1370012,2913330,5146000,9429342,0
MI,00229300,Lake Superior State University,Michigan,1602263,2845606,4978000,9425869,0
HI,02107800,University Of Hawaii - West Oahu,Hawaii,1395000,2916448,5112000,9423448,0
MN,01040200,Dakota County Technical College,Minnesota,1467178,2887495,5068000,9422673,0
AL,00103300,Oakwood University,Alabama,1573749,2860345,4984000,9418094,0
TX,00357700,Huston - Tillotson University,Texas,1630192,2823993,4953000,9407185,0
OH,01275000,Edison State Community College,Ohio,1229604,2956649,5208000,9394253,0
NY,00281000,Sage Colleges,New York,1712646,2784805,4895000,9392451,38937000
PA,00791200,Thaddeus Stevens College Of Technology,Pennsylvania,1866667,2740187,4771000,9377854,0
NH,00258200,Manchester Community College,New Hampshire,1203670,2953061,5218000,9374731,0
CO,00134500,Adams State University,Colorado,1568914,2825647,4959000,9353561,0
OK,00316300,Northwestern Oklahoma State University,Oklahoma,1506494,2857219,4988000,9351713,0
AZ,02100500,Universal Technical Institute,Arizona,9330780,0,0,9330780,0
NY,00976900,Metropolitan College Of New York,New York,1690962,2786721,4850000,9327683,0
MI,00223500,Albion College,Michigan,1831231,2729884,4760000,9321115,161113000
AZ,00824600,Dine College,Arizona,1346931,2909862,5060000,9316793,0
PA,03948300,Harrisburg University Of Science And Technology,Pennsylvania,1536586,2772298,5006000,9314884,0
CA,00697300,Canada College,California,1098544,2937222,5275000,9310766,0
PA,00327000,Gwynedd Mercy University,Pennsylvania,1673075,2765755,4871000,9309830,0
WV,00381600,Southern West Virginia Community And Technical College,West Virginia,1523218,2843370,4938000,9304588,0
PA,00335000,University Of The Arts (The),Pennsylvania,1825665,2708958,4751000,9285623,0
CA,02070500,Concordia University,California,1723598,2726592,4831000,9281190,0
WI,00385400,Lakeland University,Wisconsin,1361111,2874606,5043000,9278717,17731000
MI,00223400,Adrian College,Michigan,1752186,2735888,4783000,9271074,0
MT,00253100,Montana Technological University,Montana,1676199,2747518,4835000,9258717,0
WA,00377000,Big Bend Community College,Washington,1473837,2822644,4950000,9246481,0
OH,01287000,Southern State Community College,Ohio,1319577,2875872,5048000,9243449,0
NV,01036300,Western Nevada College,Nevada,1363469,2850200,5011000,9224669,0
MI,00228200,Madonna University,Michigan,1517426,2793087,4913000,9223513,0
IL,00166400,University Of St. Francis,Illinois,1539673,2768175,4901000,9208848,20877000
OH,01002700,James A. Rhodes State College,Ohio,1292073,2860797,5054000,9206870,0
WY,00393000,Northern Wyoming Community College District,Wyoming,1175360,2886992,5129000,9191352,0
MA,00212200,Bay Path University,Massachusetts,1431166,2817463,4941000,9189629,0
AR,01226100,North Arkansas College,Arkansas,1444804,2820340,4913000,9178144,0
KY,00901000,Madisonville Community College,Kentucky,1069051,2936703,5168000,9173754,0
KY,03083700,Galen Health Institutes,Kentucky,9167121,0,0,9167121,0
MN,00233500,Riverland Community College,Minnesota,1272243,2860474,5030000,9162717,0
KY,00198000,University Of Pikeville,Kentucky,1566531,2756839,4838000,9161370,0
NY,00282900,St. Lawrence University,New York,1808349,2660768,4691000,9160117,315661000
NY,00271300,Dominican College Of Blauvelt,New York,1684221,2710969,4748000,9143190,0
OR,00319700,Lewis & Clark College,Oregon,1827087,2625573,4680000,9132660,0
TX,04229500,Texas A&M University - Central Texas,Texas,1318324,2845060,4969000,9132384,0
PA,00680700,Community College Of Beaver County,Pennsylvania,1381963,2813941,4924000,9119904,0
WV,00381300,Glenville State College,West Virginia,1440768,2802178,4876000,9118946,0
KY,00196800,Kentucky State University,Kentucky,1372077,2817902,4926000,9115979,0
SC,00991000,Technical College Of The Lowcountry - Beaufort Campus,South Carolina,1283989,2850584,4980000,9114573,0
VA,00370400,Bridgewater College,Virginia,1799980,2653699,4645000,9098679,0
OH,00308400,Muskingum University,Ohio,1596789,2723866,4776000,9096655,79461000
MI,00231800,Spring Arbor University,Michigan,1581268,2713148,4785000,9079416,19244000
TN,00350100,Lemoyne - Owen College,Tennessee,1660276,2713735,4700000,9074011,0
MI,00229400,Monroe County Community College,Michigan,1300516,2818764,4951000,9070280,0
NY,00276000,Manhattanville College,New York,1721825,2659835,4686000,9067660,31170000
NC,00293100,Guilford College,North Carolina,1682787,2684520,4697000,9064307,78308000
IL,00172200,Mckendree University,Illinois,1636302,2686549,4713000,9035851,0
NJ,00260300,Drew University,New Jersey,1727427,2639701,4646000,9013128,183108000
NC,00298300,Wilkes Community College,North Carolina,1401082,2753588,4824000,8978670,0
IN,00182100,Marian University,Indiana,1805271,2899595,4269000,8973866,0
PA,00323000,Allegheny College,Pennsylvania,1743082,2629976,4598000,8971058,230453000
VA,00373600,Roanoke College,Virginia,1777599,2551224,4628000,8956823,148794000
AL,00569900,George Corley Wallace State Community College - Selma,Alabama,1298325,2786974,4847000,8932299,0
AZ,03120300,Collegeamerica - Flagstaff,Arizona,1792797,2524521,4612000,8929318,0
AS,01001000,American Samoa Community College,American Samoa,1617885,2669776,4638000,8925661,0
ME,00205000,University Of New England,Maine,1365831,2688237,4871000,8925068,39304000
NY,01302900,Boricua College,New York,1744981,2622688,4550000,8917669,0
FL,00146800,Saint Thomas University,Florida,1296380,2737055,4874000,8907435,0
WI,00392500,University Of Wisconsin - Superior,Wisconsin,1488367,2694797,4723000,8906164,0
OH,00304200,Denison University,Ohio,1766023,2541005,4598000,8905028,877592000
OH,00303600,Franciscan University Of Steubenville,Ohio,1604718,2635646,4659000,8899364,0
TN,00348200,Christian Brothers University,Tennessee,1600690,2647314,4641000,8889004,0
AZ,03100400,Coconino County Community College,Arizona,1104730,2805311,4970000,8880041,0
TX,02348500,Lamar State College - Port Arthur,Texas,1056684,2846257,4975000,8877941,0
NY,00267800,Bryant & Stratton College,New York,8877497,0,0,8877497,0
TX,02362000,Universal Technical Institute,Texas,8848799,0,0,8848799,0
TX,00728700,Brazosport College,Texas,1228723,2738926,4874000,8841649,0
GA,03066500,Southeastern Technical College,Georgia,1258784,2759696,4811000,8829480,0
TX,00355700,Concordia University Texas,Texas,1512530,2657370,4658000,8827900,0
FL,02515400,City College,Florida,1316096,2746762,4764000,8826858,0
CA,01011100,Cerro Coso Community College,California,908958,2844359,5069000,8822317,0
MD,00208600,Mount Saint Mary'S University,Maryland,1678019,2584181,4555000,8817200,0
NY,00276900,Marymount Manhattan College,New York,1701441,2575254,4517000,8793695,0
HI,00160500,Chaminade University Of Honolulu,Hawaii,1482800,2653900,4649000,8785700,23399000
NC,00885500,Edgecombe Community College,North Carolina,1239795,2752568,4793000,8785363,0
MA,00214700,Emmanuel College,Massachusetts,1651975,2584736,4547000,8783711,0
NM,00474300,Clovis Community College,New Mexico,857725,2390522,5532000,8780247,0
DC,00144300,Gallaudet University,District of Columbia,1642996,2601481,4528000,8772477,188190000
OH,00314300,Wittenberg University,Ohio,1728770,2558869,4484000,8771639,119174000
SC,00343600,Limestone College,South Carolina,1350503,2699581,4702000,8752084,0
MA,00212300,Becker College,Massachusetts,1645170,2580575,4514000,8739745,0
WV,04038600,Bridgevalley Community And Technical College,West Virginia,1445025,2659232,4634000,8738257,0
AR,00110500,Shorter College,Arkansas,1097484,2773066,4862000,8732550,0
CT,01115000,Asnuntuck Community College,Connecticut,1215438,2735540,4770000,8720978,0
PR,01092200,University Of Puerto Rico - Utuado,Puerto Rico,1600359,2606099,4514000,8720458,0
SD,01465900,Oglala Lakota College,South Dakota,1297595,2709233,4712000,8718828,0
NY,00285100,Suny College Of Environment Science & Forestry,New York,1681739,2550924,4483000,8715663,0
NE,00255500,Nebraska Wesleyan University,Nebraska,1382752,2644968,4687000,8714720,0
IL,01281300,John Wood Community College,Illinois,1245792,2717630,4749000,8712422,0
IL,00711900,Rend Lake College,Illinois,1182264,2719542,4804000,8705806,0
MD,00210900,Mcdaniel College,Maryland,1629536,2549733,4498000,8677269,134764000
ND,00299200,University Of Mary,North Dakota,1536188,2560792,4551000,8647980,0
TX,00497200,Galveston College,Texas,1212226,2698376,4735000,8645602,0
WA,00377900,Grays Harbor College,Washington,1303394,2671568,4669000,8643962,0
IA,00187700,North Iowa Area Community College,Iowa,1293311,2656684,4684000,8633995,32433000
NC,00294400,Mars Hill University,North Carolina,1707699,2527689,4395000,8630388,0
KS,00190200,Cowley County Community College & Area Vocational Technical School,Kansas,1206714,2692584,4723000,8622298,0
MS,00243300,Rust College,Mississippi,1359587,2646031,4615000,8620618,43445000
IN,00179500,University Of Evansville,Indiana,1681651,2503846,4416000,8601497,85667000
TX,00356400,East Texas Baptist University,Texas,1556715,2563621,4475000,8595336,0
NC,00968400,Blue Ridge Community College,North Carolina,1426892,2598523,4562000,8587415,0
NC,00808200,Cleveland Community College,North Carolina,1214574,2678304,4691000,8583878,0
TX,00366900,Wiley College,Texas,1538638,2577092,4468000,8583730,0
PA,00328000,Keystone College,Pennsylvania,1425853,2577532,4574000,8577385,0
MI,00226600,Cornerstone University,Michigan,1514292,2564593,4495000,8573885,10434000
TN,00536000,Tennessee College Of Applied Technology-Memphis,Tennessee,1453214,2595530,4522000,8570744,0
WV,04038500,Pierpont Community & Technical College,West Virginia,1154797,2698353,4712000,8565150,0
VA,00371100,Ferrum College,Virginia,1673615,2516615,4370000,8560230,53517000
MA,00212100,Babson College,Massachusetts,1761990,2433726,4362000,8557716,457670000
NC,00544700,Randolph Community College,North Carolina,1264255,2648434,4637000,8549689,0
HI,00161500,University Of Hawaii Maui College,Hawaii,1187907,2668102,4689000,8545009,0
OR,00319300,Eastern Oregon University,Oregon,1158327,2679451,4700000,8537778,0
MA,00215800,Lasell University,Massachusetts,1647941,2497307,4391000,8536248,45910000
AL,00103800,Snead State Community College,Alabama,1239198,2642522,4633000,8514720,0
SC,00344000,Newberry College,South Carolina,1592676,2521835,4391000,8505511,0
VT,00368400,Champlain College,Vermont,1368260,2577443,4549000,8494703,0
IL,00166900,Danville Area Community College,Illinois,942073,2719814,4817000,8478887,0
PA,00324500,Chestnut Hill College,Pennsylvania,1574651,2503187,4378000,8455838,0
GA,02074800,Life University,Georgia,1677181,2440082,4338000,8455263,0
DE,00143300,Wesley College,Delaware,1494069,2536920,4418000,8448989,0
IL,00726500,Carl Sandburg College,Illinois,1175052,2636911,4608000,8419963,0
PA,00326500,Franklin & Marshall College,Pennsylvania,1692121,2412793,4308000,8412914,354783000
NE,00254400,Doane University,Nebraska,1538922,2483317,4387000,8409239,113944000
NC,00295700,Queens University Of Charlotte,North Carolina,1532289,2483916,4379000,8395205,150237000
VA,00376100,Wytheville Community College,Virginia,1217475,2607176,4569000,8393651,0
MD,00207300,Goucher College,Maryland,1575324,2465931,4340000,8381255,203430000
RI,00341100,Salve Regina University,Rhode Island,1715409,2407367,4251000,8373776,63790000
NY,00281700,St. Bonaventure University,New York,1592629,2450106,4316000,8358735,74402000
NY,00270800,Barnard College,New York,1712643,2395232,4239000,8346875,363623000
TN,00349600,King University,Tennessee,1405253,2586230,4349000,8340483,0
KS,00460800,Barton County Community College,Kansas,896181,2662852,4773000,8332033,0
NC,00294500,Meredith College,North Carolina,1674515,2411617,4229000,8315132,114786000
TX,00364700,Trinity University,Texas,1665507,2394160,4239000,8298667,1280248000
KY,00200100,Thomas More University,Kentucky,1329216,2520355,4430000,8279571,0
PA,00324700,Misericordia University,Pennsylvania,1536398,2440041,4303000,8279439,54532000
SC,00343400,Furman University,South Carolina,1656467,2378551,4229000,8264018,694272000
PA,00326800,Gettysburg College,Pennsylvania,1656033,2384833,4223000,8263866,330714000
CO,00137200,Western Colorado University,Colorado,1353339,2489853,4420000,8263192,0
AL,00101500,Enterprise State Community College,Alabama,1240737,2555815,4465000,8261552,0
OR,00322200,Umpqua Community College,Oregon,1121853,2593396,4533000,8248249,0
MI,00407200,Northwood University,Michigan,1358224,2497291,4391000,8246515,97869000
HI,00525800,Hawaii Community College,Hawaii,1147226,2574000,4510000,8231226,0
MD,01031900,Fortis Institute - Towson,Maryland,8227327,0,0,8227327,0
VA,00916000,Rappahannock Community College,Virginia,1149192,2564530,4513000,8226722,0
HI,00161200,Honolulu Community College,Hawaii,1107387,2568029,4547000,8222416,0
MA,00218000,Massachusetts College Of Art And Design,Massachusetts,1510265,2432464,4278000,8220729,0
VA,00376700,Virginia Wesleyan University,Virginia,1493207,2448369,4276000,8217576,0
OK,00316500,Oklahoma Christian University,Oklahoma,1619172,2388752,4208000,8215924,0
MN,00526300,Minnesota West Community And Technical College,Minnesota,1072094,2583493,4551000,8206587,0
PA,00328500,Lancaster Bible College,Pennsylvania,1389655,2477282,4338000,8204937,0
NY,00270100,Colgate University,New York,1636002,2361476,4202000,8199478,950360000
AR,00570700,Southeast Arkansas College,Arkansas,1187530,2560591,4450000,8198121,0
GA,00155600,Brenau University,Georgia,1283197,2507744,4393000,8183941,49482000
KS,00191900,Garden City Community College,Kansas,1282005,2506940,4387000,8175945,0
MA,00219200,Mount Holyoke College,Massachusetts,1588803,2374484,4193000,8156287,794204000
IA,00184800,Southeastern Community College,Iowa,1155058,2539510,4456000,8150568,0
KS,00191000,Coffeyville Community College,Kansas,1219871,2519186,4411000,8150057,0
WI,00389200,Saint Norbert College,Wisconsin,1595105,2367509,4173000,8135614,0
WI,00919400,Lakeshore Technical College,Wisconsin,977816,2597047,4559000,8133863,0
NY,00281400,Skidmore College,New York,1640633,2340853,4152000,8133486,384280000
CA,00128100,William Jessup University,California,1486736,2407561,4232000,8126297,0
MS,00243900,Tougaloo College,Mississippi,1487317,2310909,4325000,8123226,0
MN,00234600,Concordia College - Moorhead,Minnesota,1590356,2360701,4166000,8117057,0
PR,01072400,Albizu University,Puerto Rico,1453598,2398440,4264000,8116038,0
OH,00310900,Ohio Wesleyan University,Ohio,1602505,2341490,4168000,8111995,243083000
MA,00222900,Williams College,Massachusetts,1564588,2369232,4174000,8107820,2888962000
FL,00154000,Webber International University,Florida,1470540,2417415,4209000,8096955,0
IN,00180000,Grace College And Theological Seminary,Indiana,1551701,2375929,4169000,8096630,0
GA,03155500,Oconee Fall Line Technical College,Georgia,1152438,2527282,4402000,8081720,0
IL,00170600,Lake Forest College,Illinois,1546268,2375182,4160000,8081450,90630000
TN,00352700,Tusculum University,Tennessee,1493995,2397431,4187000,8078426,0
IN,00178500,Anderson University,Indiana,1564159,2367509,4145000,8076668,0
IN,00181100,Indiana University - East,Indiana,1062722,2538074,4457000,8057796,0
UT,00367200,Lds Business College,Utah,1422523,2392206,4212000,8026729,0
NC,00846600,Southwestern Community College,North Carolina,1187630,2482510,4349000,8019140,0
PA,00330400,Muhlenberg College,Pennsylvania,1619907,2258253,4138000,8016160,288974000
OH,00304600,Franklin University,Ohio,846988,2889785,4275000,8011773,93156000
IL,00638500,Chamberlain University,Illinois,8007329,0,0,8007329,0
WV,04041400,Mountwest Community And Technical College,West Virginia,1129207,2495734,4372000,7996941,0
PA,00330300,Carlow University,Pennsylvania,1343715,2413761,4229000,7986476,0
IA,00190000,William Penn University,Iowa,1485340,2371372,4129000,7985712,0
GA,00155400,Berry College,Georgia,1589811,2313835,4079000,7982646,1058605000
MI,00227900,Lawrence Technological University,Michigan,1462382,2348383,4154000,7964765,0
PA,00336800,Saint Vincent College & Seminary,Pennsylvania,1605435,2296210,4036000,7937645,0
OK,00316600,Oklahoma City University,Oklahoma,1536667,2303854,4097000,7937521,0
IL,00170900,Lincoln College,Illinois,1279507,2432172,4221000,7932679,0
NY,00273100,Hobart And William Smith Colleges,New York,1571579,2298243,4052000,7921822,229107000
OH,00708500,Mount Vernon Nazarene University,Ohio,1330478,2390828,4194000,7915306,0
TX,00358600,Lubbock Christian University,Texas,1422450,2357712,4130000,7910162,22015000
OH,00314200,Wilmington College,Ohio,1514460,2330038,4062000,7906498,0
SC,00343900,Morris College,South Carolina,1481212,2350669,4070000,7901881,0
MA,00211500,Amherst College,Massachusetts,1574582,2283237,4012000,7869819,2473283000
OK,00315800,Murray State College,Oklahoma,1167810,2437012,4258000,7862822,0
PA,00324300,Cedar Crest College,Pennsylvania,1526417,2304150,4030000,7860567,36651000
IN,00179200,Depauw University,Indiana,1574528,2253903,4007000,7835431,730341000
LA,00997500,Northwest Louisiana Technical Community College,Louisiana,1136669,2440885,4244000,7821554,0
FL,00147200,Chipola College,Florida,1208491,2398117,4202000,7808608,0
PR,03029700,Universal Technology College Of Puerto Rico,Puerto Rico,1432599,2252260,4117000,7801859,0
CA,02110200,Columbia College Hollywood,California,1405837,2109386,4285000,7800223,0
FL,00148700,Eckerd College,Florida,1561944,2238201,3999000,7799145,60579000
OR,00322100,Treasure Valley Community College,Oregon,997664,2464882,4327000,7789546,0
TX,00365900,University Of Texas Health Science Center At San Antonio,Texas,1545801,2223504,4000000,7769305,0
AL,00100700,Central Alabama Community College,Alabama,1222052,2380348,4163000,7765400,0
NC,00298200,Western Piedmont Community College,North Carolina,1157050,2272532,4328000,7757582,0
AR,00573200,University Of Arkansas Community College At Hope-Texarkana,Arkansas,1156335,2407209,4192000,7755544,0
MN,00234100,College Of Saint Benedict,Minnesota,1572552,2204200,3966000,7742752,83506000
MO,00244900,Avila University,Missouri,1391760,2287906,4059000,7738666,0
CA,00563800,Downey Adult School,California,1232716,2288989,4214000,7735705,0
MO,00248900,Missouri Valley College,Missouri,1322917,2331466,4076000,7730383,0
NJ,02568800,Sussex County Community College,New Jersey,1156835,2381665,4191000,7729500,0
SD,00347000,South Dakota School Of Mines & Technology,South Dakota,1455698,2264943,4008000,7728641,65076000
GA,01303900,South University,Georgia,7726176,0,0,7726176,0
SC,00341700,Allen University,South Carolina,1589675,2243073,3885000,7717748,0
CT,00137400,Albertus Magnus College,Connecticut,1362920,2304400,4023000,7690320,0
GA,00154700,Point University,Georgia,1214025,2353229,4121000,7688254,0
IA,00185400,Coe College,Iowa,1525647,2234501,3928000,7688148,0
OK,02222700,Francis Tuttle Technology Center School District No. 21,Oklahoma,1347306,2237088,4095000,7679394,0
ND,00299400,Minot State University,North Dakota,1275782,2315110,4083000,7673892,0
NC,00296800,Saint Augustine'S University,North Carolina,1450038,2276686,3945000,7671724,0
TX,00361600,Southwestern Assemblies Of God University,Texas,1215532,2351126,4103000,7669658,0
NC,00296400,Southeastern Community College,North Carolina,1118302,2082781,4456000,7657083,0
NY,00281200,Trocaire College,New York,1147253,2372371,4130000,7649624,0
PA,00336200,Seton Hill University,Pennsylvania,1266845,2298815,4079000,7644660,0
ME,00982600,Kennebec Valley Community College,Maine,979695,2418076,4239000,7636771,0
PR,03025500,Mech Tech College,Puerto Rico,7627631,0,0,7627631,0
IN,00182000,Manchester University,Indiana,1511452,2188041,3927000,7626493,64470000
NC,00291000,Belmont Abbey College,North Carolina,1407500,2247933,3933000,7588433,0
MA,00211800,Assumption College,Massachusetts,1485031,2203031,3898000,7586062,102942000
MD,03100700,Carroll Community College,Maryland,1104882,2336256,4137000,7578138,0
TX,00364100,Texas Lutheran University,Texas,1408194,2237611,3910000,7555805,94530000
OR,00319800,Linfield College,Oregon,1441325,2218297,3895000,7554622,108080000
PA,00336600,Saint Francis University,Pennsylvania,1409610,2214219,3927000,7550829,52713000
OK,00317800,Seminole State College,Oklahoma,1163326,2326059,4060000,7549385,0
CA,00770700,Columbia College,California,994576,2374255,4172000,7540831,0
WA,00379900,Walla Walla University,Washington,1437520,2200713,3879000,7517233,28836000
OR,00322000,Southwestern Oregon Community College,Oregon,1081690,2334480,4095000,7511170,0
MO,00471100,State Technical College Of Missouri,Missouri,1364179,2233682,3910000,7507861,0
WV,00380900,Bluefield State College,West Virginia,1296174,2258274,3928000,7482448,0
NY,00270900,Concordia College,New York,813395,2487042,4166000,7466437,143479000
FL,00559400,Erwin Technical College,Florida,967210,2355228,4143000,7465438,0
MA,00221700,Stonehill College,Massachusetts,1498782,2143106,3820000,7461888,0
WV,00381800,University Of Charleston,West Virginia,1222988,2258339,3970000,7451327,0
WA,00378600,Peninsula College,Washington,1160439,2285928,4004000,7450367,0
MI,00226200,Kettering University,Michigan,1457033,2156693,3836000,7449726,90353000
MI,00223800,Andrews University,Michigan,1236555,2227235,3980000,7443790,0
PA,00335300,University Of The Sciences In Philadelphia,Pennsylvania,1475914,2059170,3905000,7440084,162527000
NC,00291400,Catawba College,North Carolina,1407154,2191691,3826000,7424845,0
OH,00308500,Notre Dame College Of Ohio,Ohio,1274119,2238457,3912000,7424576,0
PA,00339100,Waynesburg University,Pennsylvania,1442703,2164737,3813000,7420440,0
MN,00235800,Macalester College,Minnesota,1483970,2141894,3790000,7415864,770782000
AL,00104400,Stillman College,Alabama,1206208,2281898,3926000,7414106,0
MD,00830800,Cecil College,Maryland,1115623,2282889,4015000,7413512,0
MO,00249900,Rockhurst University,Missouri,1169737,2786245,3455000,7410982,36471000
WI,00386100,Marian University,Wisconsin,1147099,1984559,4269000,7400658,0
OR,00322700,Willamette University,Oregon,1509234,2123316,3761000,7393550,262124000
NY,00280500,Roberts Wesleyan College,New York,1381405,2180388,3830000,7391793,0
NH,00257500,Franklin Pierce University,New Hampshire,1400647,2169855,3819000,7389502,0
MN,00238900,University Of Minnesota - Morris,Minnesota,1434554,2163039,3789000,7386593,0
MA,00218700,Massachusetts College Of Liberal Arts,Massachusetts,1309397,2202852,3859000,7371249,13544000
IA,00188700,Simpson College,Iowa,1453050,2148524,3760000,7361574,0
PA,00328800,Lebanon Valley College,Pennsylvania,1442705,2135202,3781000,7358907,0
OH,00308600,Oberlin College,Ohio,1457347,2088700,3805000,7351047,943469000
PA,00329300,Lycoming College,Pennsylvania,1392658,2156676,3796000,7345334,0
NY,04210100,Stella And Charles Guttman Community College,New York,1228352,2231778,3872000,7332130,0
OH,00867700,Northwest State Community College,Ohio,962933,2284428,4075000,7322361,0
WI,00384800,Edgewood College,Wisconsin,1402919,2142831,3774000,7319750,0
KS,00703200,Midamerica Nazarene University,Kansas,1199713,2212640,3907000,7319353,0
CA,00124900,Occidental College,California,1474674,2114553,3730000,7319227,448095000
NJ,00259900,Centenary University,New Jersey,1350523,2161482,3792000,7304005,7330000
MN,00735000,Anoka Technical College,Minnesota,1108759,2251405,3943000,7303164,0
AL,00102900,University Of Mobile,Alabama,1257422,2193784,3843000,7294206,0
AR,00110200,Ouachita Baptist University,Arkansas,1344385,2155889,3781000,7281274,0
IA,00188000,Mount Mercy University,Iowa,1221083,2194529,3863000,7278612,0
CA,02063500,Coastline Community College,California,634209,2394934,4249000,7278143,0
KS,01025600,Benedictine College,Kansas,1420495,2118571,3737000,7276066,0
NM,00265500,New Mexico Junior College,New Mexico,1121004,2230402,3923000,7274406,0
RI,00340900,Rhode Island School Of Design,Rhode Island,1464915,2090083,3711000,7265998,349660000
AR,00110000,John Brown University,Arkansas,1316339,2154561,3794000,7264900,125570000
MI,00223600,Alma College,Michigan,1429939,2083777,3744000,7257716,0
WA,00379700,University Of Puget Sound,Washington,1418056,2104744,3733000,7255800,380507000
NY,00289900,Wagner College,New York,1488258,2079612,3679000,7246870,77564000
AR,04254400,Arkansas State University - Mountain Home,Arkansas,1059570,2253796,3926000,7239366,0
NY,00711100,North Country Community College,New York,1111281,2219613,3887000,7217894,0
GA,00158900,Reinhardt University,Georgia,1278399,2157472,3768000,7203871,0
NM,00265400,New Mexico Institute Of Mining & Technology,New Mexico,1353197,2121204,3727000,7201401,0
MA,00216700,Berkshire Community College,Massachusetts,1052143,2232738,3904000,7188881,0
IL,03368300,Midwest Technical Institute,Illinois,7164512,0,0,7164512,0
IA,00184700,Buena Vista University,Iowa,1123792,2192341,3827000,7143133,136568000
KS,00192100,Highland Community College,Kansas,967270,2315079,3852000,7134349,0
MI,00230800,Olivet College,Michigan,1315786,2121989,3695000,7132775,0
OH,00303700,College Of Wooster (The),Ohio,1417795,2064878,3647000,7129673,0
WA,00379400,Saint Martin'S University,Washington,1252197,2133004,3738000,7123201,0
MN,00464100,Dunwoody College Of Technology,Minnesota,1304369,2117843,3698000,7120212,0
TX,00360300,Ranger College,Texas,1047733,2201022,3868000,7116755,0
TX,02358200,Lamar State College - Orange,Texas,1043319,2206109,3865000,7114428,0
PA,00325300,Dickinson College,Pennsylvania,1436068,2030560,3640000,7106628,455442000
KS,00191600,Fort Scott Community College,Kansas,1021526,2205875,3868000,7095401,0
IL,00170000,Judson University,Illinois,1311084,2103474,3673000,7087558,0
GA,00158600,Oglethorpe University,Georgia,1279508,2105854,3687000,7072362,0
NC,00294300,Louisburg College,North Carolina,1342704,2097680,3630000,7070384,0
IA,00187400,Luther College,Iowa,1380684,2050589,3621000,7052273,168780000
WI,00391100,Viterbo University,Wisconsin,1279908,2082039,3687000,7048947,55673000
MA,00214000,College Of Our Lady Of The Elms,Massachusetts,1298135,2089016,3658000,7045151,0
PR,00502200,Universidad Central De Bayamon,Puerto Rico,958454,2224465,3862000,7044919,0
OH,00303300,Mount St. Joseph University,Ohio,1282973,2083359,3675000,7041332,0
NC,00295500,Pfeiffer University,North Carolina,1274850,2087406,3678000,7040256,0
SC,00343100,Converse College,South Carolina,1326683,2068714,3644000,7039397,78372000
GA,00159100,Shorter University,Georgia,1208080,2118322,3696000,7022402,0
TN,00349200,Freed Hardeman University,Tennessee,1353998,2051737,3614000,7019735,0
AR,02074600,South Arkansas Community College,Arkansas,1071512,2161063,3772000,7004575,0
AL,00104100,Spring Hill College,Alabama,1372682,2046512,3581000,7000194,24768000
IN,00178700,Bethel University,Indiana,1269847,2081394,3638000,6989241,0
SC,00344700,Spartanburg Methodist College,South Carolina,1322353,2070489,3595000,6987842,0
VA,00373800,Southern Virginia University,Virginia,1257205,2088697,3635000,6980902,0
NC,00294000,Lenoir Community College,North Carolina,970886,2181419,3827000,6979305,0
TN,00535900,Tennessee College Of Applied Technology - Nashville,Tennessee,1038538,1970898,3960000,6969436,0
SC,00343000,Columbia College,South Carolina,1002296,1793174,3128000,5923470,0
NY,00285300,Suny Maritime College,New York,1400241,1977394,3582000,6959635,0
IL,00168100,Highland Community College,Illinois,911809,2194108,3852000,6957917,0
FL,03037500,Hodges University,Florida,1029439,2162207,3763000,6954646,0
ID,01113300,College Of Eastern Idaho,Idaho,985694,2172759,3793000,6951453,0
TN,00350500,Maryville College,Tennessee,1401887,2010056,3507000,6918943,0
IA,00186600,Graceland University,Iowa,1147199,2070241,3696000,6913440,0
PA,00326200,Elizabethtown College,Pennsylvania,1350544,2012838,3546000,6909382,83797000
NY,04192800,Be'Er Yaakov Talmudic Seminary,New York,1335069,2035253,3524000,6894322,0
WA,00377700,Heritage University,Washington,1283643,2046489,3564000,6894132,0
PA,00328400,Lafayette College,Pennsylvania,1391019,1970926,3521000,6882945,832068000
MN,00237100,University Of Northwestern- St Paul,Minnesota,1138110,2064141,3674000,6876251,0
CA,00112700,California College Of The Arts,California,1397586,1980370,3496000,6873956,36040000
WA,03483500,Cascadia College,Washington,1156230,2051497,3665000,6872727,0
OH,00307200,Malone University,Ohio,1247915,2039528,3579000,6866443,0
FL,00990200,Sheridan Technical College,Florida,1063091,2103860,3694000,6860951,0
NC,00789200,Sampson Community College,North Carolina,1033931,2114437,3705000,6853368,0
TX,00365100,University Of Dallas,Texas,1277096,2011032,3556000,6844128,0
TX,03128100,College Of Health Care Professions (The),Texas,6835962,0,0,6835962,0
MA,00215300,Gordon College,Massachusetts,1311252,1994086,3525000,6830338,0
MD,00208000,Maryland Institute College Of Art,Maryland,1318621,1985633,3520000,6824254,94441000
WA,02576900,Charter College,Washington,6816451,0,0,6816451,0
CT,00141400,Trinity College,Connecticut,1376444,1953790,3479000,6809234,623153000
IL,00169600,Illinois Wesleyan University,Illinois,1341680,1982260,3484000,6807940,206191000
KS,00190300,Baker University,Kansas,1134284,2045379,3617000,6796663,0
MD,00465000,Chesapeake College,Maryland,917533,2135148,3742000,6794681,0
NC,00798500,South Piedmont Community College,North Carolina,977809,2100498,3704000,6782307,0
MD,00207600,Hood College,Maryland,1265284,1998556,3517000,6780840,106905000
IL,00170400,Knox College,Illinois,1328070,1982465,3466000,6776535,170174000
AR,02073500,University Of Arkansas Community College At Batesville,Arkansas,1029926,2093350,3648000,6771276,0
CA,00134300,Woodbury University,California,1199479,2029312,3542000,6770791,0
MA,00222700,Wheaton College,Massachusetts,1338514,1935305,3480000,6753819,0
OH,00306900,Lourdes University,Ohio,1108640,2044801,3600000,6753441,0
MN,00237900,Saint John'S University,Minnesota,1357136,1933994,3460000,6751130,0
MN,02260500,Summit Academy Opportunities Industrialization Center,Minnesota,1272165,1905539,3560000,6737704,0
UT,00368100,Westminster College,Utah,1897239,2895045,5092000,9884284,0
CO,00136800,Trinidad State Junior College,Colorado,1038406,2068234,3622000,6728640,0
AL,00100800,Athens State University,Alabama,845033,2140301,3741000,6726334,0
NY,00287900,Sullivan County Community College - Suny Office Of Community Colleges,New York,1038982,2053779,3632000,6724761,0
NC,00293400,Isothermal Community College,North Carolina,1012055,2073934,3632000,6717989,0
TX,00359100,Mcmurry University,Texas,1136612,2031666,3540000,6708278,94536000
VA,00372300,Mary Baldwin University,Virginia,1120685,2033234,3554000,6707919,30179000
WA,00378300,Northwest University,Washington,1075562,2038034,3582000,6695596,0
FL,01257400,Ringling College Of Art And Design,Florida,1273220,1966822,3448000,6688042,53537000
MO,03106000,Missouri State University - West Plains,Missouri,960166,2082884,3643000,6686050,0
PA,03180400,Pennsylvania Highlands Community College,Pennsylvania,880286,2100714,3704000,6685000,0
PA,00326700,Geneva College,Pennsylvania,1347254,1936527,3397000,6680781,0
MT,00677700,Flathead Valley Community College,Montana,925144,2079030,3673000,6677174,0
OH,00303500,Ohio Dominican University,Ohio,1186525,1991363,3497000,6674888,20161000
TX,00358400,Letourneau University,Texas,1050372,2033240,3589000,6672612,22055000
PA,00338900,Washington And Jefferson College,Pennsylvania,1334327,1936173,3401000,6671500,0
CA,00119600,Dominican University Of California,California,1244783,1962413,3457000,6664196,0
FL,03115500,Adventhealth University,Florida,1126242,2008706,3527000,6661948,0
OH,01073600,Marion Technical College,Ohio,953875,2068897,3637000,6659772,0
LA,00201400,Louisiana State University Health Sciences Center,Louisiana,1391236,1881142,3381000,6653378,0
AL,00101900,Huntingdon College,Alabama,1225333,1976343,3444000,6645676,0
NE,00253900,Chadron State College,Nebraska,1081277,2016084,3541000,6638361,0
OH,00813300,Zane State College,Ohio,1002163,2040434,3590000,6632597,0
VA,00370900,Emory & Henry College,Virginia,1262240,1941855,3396000,6600095,0
AZ,02098800,University Of Phoenix,Arizona,6589433,0,0,6589433,0
MA,00220600,Regis College,Massachusetts,1025140,2001630,3559000,6585770,0
NY,00272900,Hartwick College,New York,1271783,1933993,3377000,6582776,76792000
TX,01050900,Hallmark University,Texas,1304065,1925928,3348000,6577993,0
TX,00354300,Austin College,Texas,1342606,1904577,3330000,6577183,149667000
OH,00827800,Terra State Community College,Ohio,852360,2073348,3642000,6567708,0
MA,00219700,Nichols College,Massachusetts,1236801,1932689,3393000,6562490,17345000
IL,00175200,Sauk Valley Community College,Illinois,926411,2045042,3590000,6561453,0
CT,00140900,University Of Saint Joseph,Connecticut,1158343,1948054,3453000,6559397,34781000
PA,00398700,La Roche University,Pennsylvania,1205918,1942542,3401000,6549460,0
IL,00174800,Rockford University,Illinois,1225910,1931238,3382000,6539148,0
TX,00361000,Schreiner University,Texas,1181201,1944297,3407000,6532498,0
OK,00315500,Eastern Oklahoma State College,Oklahoma,937568,2035000,3554000,6526568,0
ID,00162400,Northwest Nazarene University,Idaho,820668,2039850,3661000,6521518,0
AR,00110400,Phillips Community College Of The University Of Arkansas,Arkansas,905327,2043633,3570000,6518960,0
TN,03440300,Baptist Memorial College Of Health Sciences,Tennessee,1141951,1959332,3412000,6513283,0
OR,00318600,Blue Mountain Community College,Oregon,966862,2004616,3527000,6498478,0
CT,00730300,Lincoln Technical Institute,Connecticut,6495045,0,0,6495045,0
NH,00258300,Great Bay Community College,New Hampshire,870169,2028155,3584000,6482324,0
MI,00229900,North Central Michigan College,Michigan,835428,2034633,3605000,6475061,0
MI,00223900,Aquinas College,Michigan,1204512,1910297,3357000,6471809,0
IA,00187300,Loras College,Iowa,1272730,1883667,3307000,6463397,41584000
IA,00189600,Wartburg College,Iowa,1289269,1876934,3297000,6463203,0
MA,00216900,Greenfield Community College,Massachusetts,887515,2023815,3547000,6458330,0
TX,00360200,Paul Quinn College,Texas,1163719,1937535,3357000,6458254,0
NJ,01246100,Lincoln Technical Institute,New Jersey,6452823,0,0,6452823,0
PA,00339200,Westminster College,Pennsylvania,1265227,1876014,3298000,6439241,0
NE,00255300,Midland University,Nebraska,1102337,1920489,3403000,6425826,0
LA,00200700,Louisiana College,Louisiana,1147506,1920379,3356000,6423885,0
CT,01053000,Quinebaug Valley Community College,Connecticut,889048,2015443,3515000,6419491,0
NM,02083900,Northern New Mexico College,New Mexico,1051562,1957707,3402000,6411269,0
NE,00689500,University Of Nebraska Medical Center,Nebraska,1295673,1817776,3295000,6408449,0
IN,00183600,Saint Mary'S College,Indiana,1201641,1886322,3319000,6406963,201649000
MO,00251400,North Central Missouri College,Missouri,892038,2004717,3509000,6405755,0
KY,00196000,Spalding University,Kentucky,1155755,1902707,3346000,6404462,0
UT,02156600,Davis Technical College,Utah,713275,1890758,3790000,6394033,0
TN,00349000,Fisk University,Tennessee,1085474,1829862,3475000,6390336,0
KS,00193900,Newman University,Kansas,993846,1934708,3455000,6383554,0
PA,00324400,Chatham University,Pennsylvania,1162375,1858720,3357000,6378095,94216000
MT,00253700,University Of Montana Western (The),Montana,1164902,1891743,3310000,6366645,0
CA,00117300,Pomona College,California,1285644,1834733,3243000,6363377,2324594000
IL,00168800,Illinois College,Illinois,1239311,1850025,3271000,6360336,129905000
KY,00198800,Union College,Kentucky,1308850,1956695,3416000,6681545,0
ME,00203900,Colby College,Maine,1244996,1803716,3275000,6323712,869927000
WV,00383000,West Virginia Wesleyan College,West Virginia,1242558,1847605,3232000,6322163,0
NC,00798700,Bladen Community College,North Carolina,861961,1987811,3465000,6314772,0
FL,04263400,Florida Polytechnic University,Florida,1253303,1838614,3221000,6312917,0
TX,03035300,Southern Careers Institute,Texas,6305240,0,0,6305240,0
OH,00301000,Antioch University,Ohio,1107211,1813557,3363000,6283768,0
NY,00272800,Hamilton College,New York,1189507,1837979,3254000,6281486,969362000
IA,00186400,Iowa Lakes Community College,Iowa,966888,1921737,3389000,6277625,0
NY,03095500,Asa College,New York,6272628,0,0,6272628,0
WI,00386900,Mount Mary University,Wisconsin,1157273,1857770,3250000,6265043,0
NC,00291700,College Of The Albemarle,North Carolina,909714,1936881,3411000,6257595,0
TX,00362000,Southwestern University,Texas,1213449,1828552,3214000,6256001,296413000
SD,00345800,Augustana University,South Dakota,1215394,1816774,3213000,6245168,0
KS,00193000,Labette Community College,Kansas,812240,1961626,3471000,6244866,0
NC,00290800,Barton College,North Carolina,1161318,1847742,3223000,6232060,0
OH,00304800,Heidelberg University,Ohio,1190956,1831777,3206000,6228733,51987000
IA,00187900,Morningside College,Iowa,1147631,1832741,3232000,6212372,46271000
MI,00677100,College For Creative Studies,Michigan,1136489,1841570,3228000,6206059,0
NY,00273400,Houghton College,New York,1272224,1798688,3135000,6205912,57372000
TX,00355400,Clarendon College,Texas,885687,1913765,3388000,6187452,0
VT,00369400,Saint Michael'S College,Vermont,1186800,1795756,3195000,6177556,89061000
CA,00117900,Notre Dame De Namur University,California,1121450,1836201,3219000,6176651,0
MA,00218100,Massachusetts Maritime Academy,Massachusetts,1242689,1739892,3177000,6159581,0
MA,00214400,Dean College,Massachusetts,1087115,1840110,3225000,6152225,0
SD,00346900,University Of Sioux Falls,South Dakota,1036173,1853841,3259000,6149014,30327000
KS,01043800,Haskell Indian Nations University,Kansas,1111478,1837814,3195000,6144292,0
OH,01045300,Washington State Community College,Ohio,926232,1892309,3319000,6137541,0
WI,00383700,Cardinal Stritch University,Wisconsin,1031055,1849327,3256000,6136382,0
FL,00561200,Manatee Technical College,Florida,1015473,1851459,3253000,6119932,0
SC,00342700,Coker University,South Carolina,1147692,1809360,3161000,6118052,45680000
OH,00303900,Columbus College Of Art & Design,Ohio,1168931,1801090,3143000,6113021,0
NC,00295800,Rockingham Community College,North Carolina,933713,1876718,3288000,6098431,0
TN,00352500,Tennessee Wesleyan University,Tennessee,1192356,1787165,3116000,6095521,0
FL,00884800,Warner University,Florida,1078101,1829015,3185000,6092116,0
TN,00535100,Tennessee College Of Applied Technology - Morristown,Tennessee,877779,1711569,3501000,6090348,0
VA,00370200,Averett University,Virginia,1055659,1828557,3200000,6084216,21268000
MA,00466100,Hampshire College,Massachusetts,1199199,1776110,3105000,6080309,0
CT,00137900,Connecticut College,Connecticut,1202711,1753472,3114000,6070183,313510000
IA,00186800,Grinnell College,Iowa,1190471,1761684,3107000,6059155,2069953000
IL,00177100,Trinity Christian College,Illinois,1067149,1812382,3176000,6055531,0
NC,00291800,Davidson College,North Carolina,1220411,1743286,3090000,6053697,881465000
NY,00476500,Cuny Graduate School & University Center,New York,776134,1877959,3393000,6047093,0
IN,00183800,Taylor University,Indiana,1073311,1793326,3178000,6044637,98717000
CA,00118700,College Of The Siskiyous,California,785260,1909035,3349000,6043295,0
KS,00191800,Friends University,Kansas,1018077,1814055,3211000,6043132,53324000
OR,03428300,Klamath Community College,Oregon,699314,1932447,3391000,6022761,0
KS,00191300,Dodge City Community College,Kansas,949264,1820945,3251000,6021209,0
ND,00298800,Bismarck State College,North Dakota,914066,1834237,3249000,5997303,0
AR,02348200,Arkansas State University Mid-South,Arkansas,855413,1869661,3266000,5991074,0
MI,00229500,Montcalm Community College,Michigan,861963,1861770,3259000,5982733,0
CA,00125800,Pacific Union College,California,1138223,1763069,3080000,5981292,0
PA,00337000,Swarthmore College,Pennsylvania,1200865,1729865,3049000,5979730,2131553000
VT,00369800,Vermont Technical College,Vermont,971406,1813509,3186000,5970915,0
GA,00154200,Agnes Scott College,Georgia,1148230,1754874,3063000,5966104,217142000
CO,00136100,Northeastern Junior College,Colorado,868359,1708469,3380000,5956828,0
CO,00136200,Otero Junior College,Colorado,902921,1839224,3213000,5955145,0
WI,00766900,Southwest Wisconsin Technical College,Wisconsin,783630,1868092,3299000,5950722,0
NY,00288900,Union College,New York,1159940,1707070,3033000,5900010,0
CA,02241800,American Career College,California,5944572,0,0,5944572,0
WV,00380600,Alderson Broaddus University,West Virginia,1126674,1753272,3057000,5936946,0
TN,00351900,Rhodes College,Tennessee,1205945,1694962,3027000,5927907,352206000
MD,00209500,Saint Mary'S College Of Maryland,Maryland,1173755,1716025,3027000,5916780,0
NY,01302700,Yeshivath Viznitz,New York,1198248,1724833,2993000,5916081,0
NH,00923600,Nashua Community College,New Hampshire,802358,1845578,3265000,5912936,0
OH,00314100,Wilberforce University,Ohio,689372,1911149,3311000,5911521,0
OH,00304900,Hiram College,Ohio,1033772,1774527,3099000,5907299,0
NY,00397900,"Teachers College, Columbia University",New York,1118534,1680289,3107000,5905823,345191000
NH,00258700,Saint Anselm College,New Hampshire,1134675,1695795,3067000,5897470,164005000
PA,00327600,Immaculata University,Pennsylvania,1006089,1763406,3125000,5894495,0
MI,00227500,Kalamazoo College,Michigan,1178454,1709694,3006000,5894148,240344000
MN,00406900,University Of Minnesota - Crookston,Minnesota,864154,1816506,3207000,5887660,0
MN,00234000,Carleton College,Minnesota,1168048,1699739,3017000,5884787,892353000
FL,02547600,Florida National University,Florida,5884598,0,0,5884598,0
FL,03108500,Everglades University,Florida,776027,1751606,3354000,5881633,0
NY,00678900,Columbia - Greene Community College - Suny Office Of Cmnty Colleges,New York,840707,1827663,3203000,5871370,0
TX,00495200,University Of Texas Medical Branch At Galveston,Texas,1101752,1693386,3055000,5850138,0
PA,03090800,Lake Erie College Of Osteopathic Medicine,Pennsylvania,1233436,1615729,2987000,5836165,0
IL,00769300,Shawnee Community College,Illinois,637619,1880324,3318000,5835943,0
FL,00558500,Lively Technical College,Florida,942497,1782744,3105000,5830241,0
SD,00346300,Dakota State University,South Dakota,771997,1819817,3223000,5814814,226626000
PR,02460000,University Of Puerto Rico - Medical Science Campus,Puerto Rico,1190264,1662218,2962000,5814482,0
KY,00195200,Asbury University,Kentucky,1017118,1736565,3046000,5799683,0
CA,00123800,Mills College,California,1135582,1693357,2965000,5793939,196404000
DC,00145900,Strayer University,District of Columbia,5792122,0,0,5792122,0
FL,01226300,Atlantic Technical College,Florida,758163,1801531,3225000,5784694,0
WI,00385600,Lawrence University Of Wisconsin,Wisconsin,1157627,1673315,2953000,5783942,356958000
VA,00370700,Richard Bland College,Virginia,820734,1790616,3163000,5774350,0
NY,01265200,Onondaga Cortland Madison Boces,New York,842620,1457826,3470000,5770446,0
KY,00199300,Henderson Community College,Kentucky,806658,1807184,3156000,5769842,0
AR,00109900,Hendrix College,Arkansas,1056780,1687170,3024000,5767950,200680000
VA,00374700,University Of Virginia'S College At Wise (The),Virginia,788966,1804120,3173000,5766086,0
AZ,01186200,Northland Pioneer College,Arizona,643137,1842485,3280000,5765622,0
PR,02340600,Humacao Community College,Puerto Rico,967546,1755904,3038000,5761450,0
IN,00183000,Rose - Hulman Institute Of Technology,Indiana,1191507,1644105,2924000,5759612,0
SC,00345500,Voorhees College,South Carolina,1124053,1695557,2934000,5753610,0
MA,03130500,Urban College Of Boston,Massachusetts,608706,1874227,3261000,5743933,0
GA,02284300,Interactive College Of Technology,Georgia,5735726,0,0,5735726,0
ME,00203800,Bowdoin College,Maine,1123660,1657730,2936000,5717390,1743663000
CO,00134700,Colorado College,Colorado,1157391,1638010,2921000,5716401,766910000
MN,00236900,North Central University,Minnesota,1046302,1692123,2956000,5694425,0
IL,02214100,Resurrection University,Illinois,1061270,1685149,2942000,5688419,0
MO,00246000,Culver-Stockton College,Missouri,1067399,1676752,2929000,5673151,29467000
NJ,02503900,Warren County Community College,New Jersey,686371,1791312,3191000,5668683,0
TN,00402500,Tennessee College Of Applied Technology - Knoxville,Tennessee,822349,1739895,3106000,5668244,0
PA,00338500,Ursinus College,Pennsylvania,1149294,1637237,2880000,5666531,131213000
MA,02182900,Cambridge College,Massachusetts,925862,1702049,3031000,5658911,0
WY,00393300,Western Wyoming Community College,Wyoming,725242,1774485,3159000,5658727,0
CA,03250300,Cbd College,California,959316,1713690,2983000,5656006,0
MD,00206500,Notre Dame Of Maryland University,Maryland,969449,1687957,2996000,5653406,35835000
IA,00185900,Dordt University,Iowa,1082435,1654086,2915000,5651521,0
NE,00256000,Western Nebraska Community College,Nebraska,805697,1757098,3087000,5649795,0
MT,02143400,Salish Kootenai College,Montana,832524,1754585,3062000,5649109,0
CA,00117600,West Hills Community College,California,592666,1822336,3224000,5639002,0
CA,00125100,Otis College Of Art & Design,California,1100507,1648794,2887000,5636301,0
IL,00174500,Quincy University,Illinois,1041392,1668907,2924000,5634299,0
AR,02087000,Ozarka College,Arkansas,797075,1763049,3069000,5629124,0
NC,01119400,Stanly Community College,North Carolina,731366,1777412,3110000,5618778,0
KS,00193600,Neosho County Community College,Kansas,806338,1742066,3070000,5618404,0
NE,00255900,Peru State College,Nebraska,827344,1737928,3053000,5618272,0
NE,00254100,Concordia University,Nebraska,1017489,1656961,2940000,5614450,0
MI,00224000,Bay De Noc Community College,Michigan,778116,1757060,3079000,5614176,0
MT,00931400,Great Falls College Montana State University,Montana,845222,1730333,3027000,5602555,0
OH,03097000,Mercy College Of Ohio,Ohio,886791,1716262,2996000,5599053,0
TN,00349500,Johnson University,Tennessee,997716,1667345,2918000,5583061,0
OH,02196300,Collins Career Technical Center,Ohio,1024753,1439028,3117000,5580781,0
NY,00268500,Cazenovia College,New York,1008776,1661084,2903000,5572860,0
AR,01226000,East Arkansas Community College,Arkansas,840222,1724373,2992000,5556595,0
VA,00375300,Virginia Military Institute,Virginia,1132691,1565705,2853000,5551396,0
ND,02301100,Turtle Mountain Community College,North Dakota,947936,1682904,2920000,5550840,0
NC,00808100,Carteret Community College,North Carolina,774946,1556031,3218000,5548977,0
IL,00168400,Greenville University,Illinois,957351,1667764,2919000,5544115,21160000
IL,00177200,Trinity International University,Illinois,903509,1670121,2966000,5539630,0
CT,00139800,Northwestern Connecticut Community College,Connecticut,602265,1431434,3501000,5534699,0
GA,00157800,Lagrange College,Georgia,1074446,1622319,2835000,5531765,53005000
TN,00353400,University Of The South (The),Tennessee,1094094,1598238,2836000,5528332,0
PA,00327900,Juniata College,Pennsylvania,1082356,1605406,2830000,5517762,0
OK,00961800,Tulsa Welding School,Oklahoma,5505774,0,0,5505774,0
MI,00223700,Alpena Community College,Michigan,759853,1717931,3019000,5496784,0
AR,02220900,Cossatot Community College Of The University Of Arkansas,Arkansas,775262,1715171,3003000,5493433,0
PA,00330200,Mount Aloysius College,Pennsylvania,816503,1686780,2984000,5487283,43986000
OR,00488200,Oregon Health & Science University,Oregon,1012193,1597982,2872000,5482175,0
TN,00528100,Tennessee College Of Applied Technology - Elizabethton,Tennessee,881164,1549711,3042000,5472875,0
SC,00345700,Wofford College,South Carolina,1103905,1561734,2802000,5467639,211673000
NE,00254000,College Of Saint Mary,Nebraska,1055309,1602125,2810000,5467434,0
WI,00383500,Beloit College,Wisconsin,1086370,1588329,2790000,5464699,114121000
SD,01017000,Western Dakota Technical Institute,South Dakota,863880,1673430,2920000,5457310,0
TN,00778200,Tennessee College Of Applied Technology - Dickson,Tennessee,821613,1517962,3104000,5443575,0
NE,00255700,Mid-Plains Community College,Nebraska,774946,1687412,2978000,5440358,0
CA,00122000,Master'S University And Seminary (The),California,936440,1616925,2885000,5438365,0
MN,00554400,Alexandria Technical And Community College,Minnesota,807310,1669171,2957000,5433481,0
NC,00295300,William Peace University,North Carolina,1006338,1612358,2812000,5430696,50222000
TX,02305300,Parker University,Texas,970426,1604204,2842000,5416630,0
NJ,00260000,College Of Saint Elizabeth,New Jersey,935846,1630679,2850000,5416525,0
OK,00920400,Kiamichi Technology Center,Oklahoma,1023214,1570953,2817000,5411167,0
CA,00974800,Carrington College,California,5403151,0,0,5403151,0
KS,00194300,University Of Saint Mary,Kansas,976950,1603725,2814000,5394675,0
IN,00180100,Hanover College,Indiana,1065765,1569890,2748000,5383655,146078000
IN,00179800,Franklin College Of Indiana,Indiana,1071874,1562660,2743000,5377534,0
WV,00905400,West Virginia Northern Community College,West Virginia,732317,1686844,2952000,5371161,0
CO,01287500,Pickens Technical College,Colorado,839917,1623436,2905000,5368353,0
KS,00190900,Cloud County Community College,Kansas,763297,1667878,2937000,5368175,0
TN,00350400,Martin Methodist College,Tennessee,963462,1603235,2794000,5360697,0
IL,00172500,Monmouth College,Illinois,1069404,1561080,2729000,5359484,122619000
VA,00373300,Randolph - Macon College,Virginia,1058238,1556549,2743000,5357787,0
ND,00299600,North Dakota State College Of Science,North Dakota,823352,1641417,2889000,5353769,0
AR,00109400,University Of The Ozarks,Arkansas,1011314,1582461,2759000,5352775,115068000
DE,00142900,Goldey-Beacom College,Delaware,1040019,1561354,2747000,5348373,0
MT,00253300,Montana State University - Northern,Montana,911258,1614369,2820000,5345627,0
MA,00211700,Anna Maria College,Massachusetts,911801,1619045,2809000,5339846,0
NC,02170700,Brunswick Community College,North Carolina,795340,1651117,2893000,5339457,0
MD,03493300,All-State Career,Maryland,5309772,0,0,5309772,0
MO,00246400,Fontbonne University,Missouri,986867,1567916,2750000,5304783,0
AL,00101200,Birmingham-Southern College,Alabama,1069855,1533280,2696000,5299135,0
NY,03193300,Manhattan School Of Computer Technology,New York,801874,1639673,2838000,5279547,0
TX,00357500,Howard Payne University,Texas,1041913,1536043,2687000,5264956,62865000
IN,00180300,Huntington University,Indiana,960261,1561180,2741000,5262441,0
OK,00317400,Oklahoma Panhandle State University,Oklahoma,882583,1591219,2781000,5254802,0
NC,00293000,Greensboro College,North Carolina,962182,1553970,2717000,5233152,0
MN,03129100,Fond Du Lac Tribal & Community College,Minnesota,744831,1624762,2862000,5231593,0
MD,00206700,Washington Adventist University,Maryland,805558,1602392,2813000,5220950,0
MD,00210800,Washington College,Maryland,1047397,1494341,2678000,5219738,236685000
NY,04115500,Talmudical Seminary Of Bobov,New York,949733,1467438,2798000,5215171,0
OK,00316700,University Of Science & Arts Of Oklahoma,Oklahoma,1020519,1529512,2662000,5212031,0
NC,00296000,Salem College,North Carolina,1007410,1532126,2669000,5208536,0
AR,03105200,Baptist Health College Little Rock,Arkansas,876349,1410310,2918000,5204659,0
SC,00344500,Presbyterian College,South Carolina,1038216,1506419,2650000,5194635,91533000
SC,00342200,Southern Wesleyan University,South Carolina,841417,1583800,2768000,5193217,0
MI,00717100,Kirtland Community College,Michigan,712739,1629004,2842000,5183743,0
UT,02346500,Ogden-Weber Technical College,Utah,596044,1595765,2991000,5182809,0
OK,00694200,Mid-America Christian University,Oklahoma,716752,1622104,2832000,5170856,0
TN,02103500,Tennessee College Of Applied Technology - Murfreesboro,Tennessee,607231,1165386,3392000,5164617,0
KS,00190400,Bethany College,Kansas,1005488,1511010,2632000,5148498,0
WV,00381100,Davis & Elkins College,West Virginia,980322,1518906,2646000,5145228,0
NC,00484500,Wilson Community College,North Carolina,718656,1606406,2819000,5144062,0
CA,02482700,Western University Of Health Sciences,California,1105699,1417353,2620000,5143052,0
NH,00258600,Rivier University,New Hampshire,902722,1529331,2703000,5135053,41389000
NJ,04134100,Jersey College,New Jersey,5119863,0,0,5119863,0
PA,00323700,Bryn Mawr College,Pennsylvania,1022842,1472661,2623000,5118503,907976000
GA,00160400,Young Harris College,Georgia,1019320,1486015,2609000,5114335,0
NY,00283200,Saint Thomas Aquinas College,New York,489023,1662920,2953000,5104943,0
AR,00110900,University Of Arkansas For Medical Sciences,Arkansas,972976,1458213,2622000,5053189,0
NE,00254800,Hastings College,Nebraska,1051950,1452549,2544000,5048499,0
KY,00197500,Midway University,Kentucky,892872,1614558,2535000,5042430,0
CA,03113300,Uei College,California,5025381,0,0,5025381,0
KY,00196400,Georgetown College,Kentucky,934826,1481847,2605000,5021673,0
NY,00678700,Clinton Community College - Suny Office Of Community Colleges,New York,765962,1545848,2705000,5016810,0
PA,00329400,Manor College,Pennsylvania,790389,1541671,2678000,5010060,0
VA,00376800,Washington And Lee University,Virginia,1045044,1418018,2539000,5002062,1676308000
NC,00855800,Beaufort County Community College,North Carolina,695419,1563932,2742000,5001351,0
NC,00293900,Lees-Mcrae College,North Carolina,925656,1485773,2587000,4998429,0
MO,00252500,William Woods University,Missouri,894737,1476897,2620000,4991634,0
PA,00339600,Wilson College,Pennsylvania,843869,1498967,2647000,4989836,55338000
WV,03960300,New River Community And Technical College,West Virginia,688982,1567267,2731000,4987249,0
KS,00822800,Seward County Community College,Kansas,734560,1535377,2712000,4981937,0
AL,00526000,J. F. Drake State Community And Technical College,Alabama,761763,1539687,2679000,4980450,0
SD,00828400,Mitchell Technical Institute,South Dakota,879422,1485562,2600000,4964984,0
CA,00118300,Holy Names University,California,895448,1475062,2577000,4947510,54171000
AR,00773800,Southern Arkansas University Tech,Arkansas,782909,1507722,2645000,4935631,0
UT,03413300,Mountainland Technical College,Utah,609482,1545193,2778000,4932675,0
FL,02115300,Pinellas Technical College - St. Petersburg Campus,Florida,621026,1536181,2766000,4923207,0
WI,02136600,Wisconsin Lutheran College,Wisconsin,925999,1448476,2543000,4917475,36629000
KY,00196100,Centre College Of Kentucky,Kentucky,986773,1421366,2509000,4917139,0
FL,00150800,North Florida College,Florida,715483,1528120,2673000,4916603,0
AR,00108700,Arkansas Baptist College,Arkansas,831019,1482487,2597000,4910506,0
CA,00113400,California State University Maritime Academy,California,977757,1381700,2550000,4909457,0
PA,00330900,Peirce College,Pennsylvania,611389,1562718,2722000,4896107,23557000
SC,00345400,University Of South Carolina - Salkehatchie,South Carolina,783241,1496153,2608000,4887394,0
NY,00276300,Maria College,New York,697463,1370774,2393000,4461237,0
SD,00346600,Northern State University,South Dakota,659777,1518172,2699000,4876949,0
VA,00370800,Eastern Mennonite University,Virginia,893425,1442117,2540000,4875542,0
CA,02155300,Chicago School Of Professional Psychology,California,756112,1860461,2256000,4872573,0
CA,00129100,Simpson University,California,892430,1445294,2518000,4855724,0
GA,00158700,Paine College,Georgia,798094,1484462,2571000,4853556,0
TN,00672500,University Of Tennessee Health Science Center,Tennessee,998078,1363552,2491000,4852630,0
LA,03294300,Blue Cliff College,Louisiana,4843075,0,0,4843075,0
ME,00203600,Bates College,Maine,953516,1395754,2487000,4836270,329723000
IA,00185000,Central College,Iowa,928577,1416092,2488000,4832669,0
GA,00156300,Emmanuel College,Georgia,871449,1442139,2519000,4832588,0
KY,00196900,Kentucky Wesleyan College,Kentucky,843204,1448016,2523000,4814220,0
PA,04221300,Philadelphia Technician Training Institute,Pennsylvania,675783,1503388,2626000,4805171,0
MN,00239300,Minnesota State College Southeast,Minnesota,666447,1499186,2636000,4801633,0
CA,00113200,California Institute Of The Arts,California,1014886,1365215,2418000,4798101,178839000
MT,00253400,Rocky Mountain College,Montana,933392,1401924,2455000,4790316,32055000
CA,03969600,Uei College,California,4785647,0,0,4785647,0
MN,00235500,Hibbing Community College,Minnesota,779596,1451871,2540000,4771467,0
OK,01005300,"Indian Capital Technology Center, School District Number 4",Oklahoma,885933,1404206,2480000,4770139,0
OR,00322500,Warner Pacific University,Oregon,778206,1451123,2538000,4767329,0
NC,00768700,James Sprunt Community College,North Carolina,661318,1375164,2728000,4764482,0
IL,00164300,Spoon River College,Illinois,617648,1506166,2639000,4762814,0
CA,00859700,Feather River College,California,599153,1495117,2666000,4760270,0
ME,00205200,Thomas College,Maine,762266,1438966,2540000,4741232,19614000
OH,00994100,Belmont College,Ohio,773450,1444467,2523000,4740917,0
IL,00163900,Blackburn University,Illinois,913064,1398751,2428000,4739815,0
IA,00184600,Briar Cliff University,Iowa,853293,1407399,2467000,4727692,0
PA,00337600,Thiel College,Pennsylvania,931754,1380896,2406000,4718650,0
IL,01072700,Devry University,Illinois,4713768,0,0,4713768,0
IN,00179300,Earlham College,Indiana,958680,1361707,2391000,4711387,418845000
MT,00252600,Carroll College,Montana,941622,1361291,2401000,4703913,44828000
MI,00228800,Rochester University,Michigan,787257,1424071,2486000,4697328,0
WI,00388400,Ripon College,Wisconsin,908784,1364469,2422000,4695253,94328000
AR,00997600,College Of The Ouachitas,Arkansas,669324,1457805,2553000,4680129,0
KS,00192400,Independence Community College,Kansas,746807,1432021,2500000,4678828,0
NY,00281300,Sarah Lawrence College,New York,944456,1338169,2391000,4673625,117046000
SC,00760200,Northeastern Technical College,South Carolina,544363,1504443,2624000,4672806,0
PA,00986300,Pennsylvania College Of Health Sciences,Pennsylvania,778640,1405978,2472000,4656618,0
MN,00235600,Itasca Community College,Minnesota,741976,1421466,2493000,4656442,0
FL,03941300,Ave Maria University,Florida,927779,1339857,2377000,4644636,0
NY,00279500,Paul Smith'S College Of Arts & Sciences,New York,922258,1357184,2364000,4643442,0
CT,01077900,Porter And Chester Institute,Connecticut,4642939,0,0,4642939,0
OH,00306500,Kenyon College,Ohio,940498,1315552,2382000,4638050,422019000
KY,00198700,Transylvania University,Kentucky,878886,1278124,2472000,4629010,191238000
AR,00109300,Central Baptist College,Arkansas,822986,1385745,2412000,4620731,0
TX,00954900,Western Texas College,Texas,556115,1449094,2614000,4619209,0
WI,02077100,Milwaukee Institute Of Art & Design,Wisconsin,840652,1374550,2395000,4610202,0
NY,00271800,Elmira College,New York,917861,1340299,2344000,4602160,0
NY,04208600,Relay Graduate School Of Education,New York,740441,1355661,2506000,4602102,0
NY,00288500,Albany College Of Pharmacy And Health Sciences,New York,941221,1299052,2360000,4600273,0
NY,00739400,Berkeley College,New York,4596874,0,0,4596874,0
OR,00133900,Corban University,Oregon,887403,1343986,2364000,4595389,0
CA,00134100,Westmont College,California,950992,1311893,2316000,4578885,78908000
NY,03652300,Metropolitan Learning Institute,New York,660220,1394537,2521000,4575757,0
CA,01047400,Marymount California University,California,874466,1342246,2345000,4561712,0
FL,02501500,Orange Technical College - Mid Florida Campus,Florida,538345,1444270,2573000,4555615,0
NY,04138100,Yeshiva Of Machzikai Hadas,New York,895153,1337216,2318000,4550369,0
OK,00315600,Redlands Community College,Oklahoma,608459,1427978,2511000,4547437,0
IA,00185600,Cornell College,Iowa,845562,1330085,2367000,4542647,76288000
PR,03021900,Edic College,Puerto Rico,4538123,0,0,4538123,0
OK,00315100,Oklahoma Wesleyan University,Oklahoma,797766,1361300,2379000,4538066,0
MT,00757000,Helena College University Of Montana,Montana,685627,1394148,2451000,4530775,0
HI,01122000,Windward Community College,Hawaii,551098,1432714,2539000,4522812,0
OH,00307300,Marietta College,Ohio,870471,1322182,2330000,4522653,88469000
ME,03122900,York County Community College,Maine,556529,1436695,2521000,4514224,0
OK,00314600,Western Oklahoma State College,Oklahoma,635791,1409851,2463000,4508642,0
IA,00627300,Mercy College Of Health Sciences,Iowa,805957,1345841,2347000,4498798,0
PA,00335100,Cairn University,Pennsylvania,771522,1343540,2364000,4479062,0
ND,00299000,University Of Jamestown,North Dakota,848958,1316400,2310000,4475358,0
TX,00361900,Southwestern Adventist University,Texas,801162,1339319,2334000,4474481,0
NY,00289600,Villa Maria College Of Buffalo,New York,807056,1340693,2325000,4472749,0
IA,00187500,Marshalltown Community College,Iowa,636628,1384816,2445000,4466444,0
NJ,00750200,Berkeley College,New Jersey,4464258,0,0,4464258,0
KS,00192900,Kansas Wesleyan University,Kansas,823462,1320499,2303000,4446961,0
CA,00701200,Samuel Merritt University,California,841525,1284267,2310000,4435792,51316000
CA,00113100,California Institute Of Technology,California,908781,1254418,2270000,4433199,2975376000
IL,00175700,Southeastern Illinois College,Illinois,460547,1429347,2537000,4426894,0
NV,04065300,Roseman University Of Health Sciences,Nevada,893841,1213666,2307000,4414507,0
NC,00398100,University Of North Carolina School Of The Arts,North Carolina,868886,1268365,2259000,4396251,0
LA,00202300,University Of Holy Cross,Louisiana,708685,1338263,2348000,4394948,0
NJ,00546100,Salem Community College,New Jersey,665129,1352495,2372000,4389624,0
ME,00204400,Maine Maritime Academy,Maine,876568,1263932,2248000,4388500,0
IA,00188300,Northwestern College,Iowa,822778,1291574,2273000,4387352,0
LA,03106200,Franciscan Missionaries Of Our Lady University,Louisiana,721431,1324432,2338000,4383863,0
OH,00306600,Lake Erie College,Ohio,803405,1292618,2272000,4368023,0
ME,00204100,University Of Maine - Fort Kent,Maine,626037,1353803,2386000,4365840,0
NC,00808300,Haywood Community College,North Carolina,614386,1361522,2385000,4360908,0
WY,00393100,Northwest College,Wyoming,732668,1311889,2313000,4357557,38942000
IL,00622800,Methodist College,Illinois,736004,1319115,2298000,4353119,0
MN,00553500,Pine Technical And Community College,Minnesota,481263,1397218,2470000,4348481,0
NY,00273500,Hilbert College,New York,683112,1329533,2331000,4343645,0
SC,00342600,University Of South Carolina - Sumter,South Carolina,705800,1321358,2316000,4343158,0
KY,00195100,Alice Lloyd College,Kentucky,754640,1309966,2277000,4341606,0
NC,00291100,Bennett College,North Carolina,768798,1301805,2264000,4334603,0
PA,00327400,Haverford College,Pennsylvania,873803,1246052,2210000,4329855,529487000
MA,04143200,Hult International Business School,Massachusetts,882754,1209495,2224000,4316249,0
TX,00850400,Richland College,Texas,4316107,0,0,4316107,0
ME,00685800,Unity College,Maine,822158,1266150,2214000,4302308,77308000
MO,00247300,Kansas City Art Institute,Missouri,840665,1262617,2199000,4302282,0
MN,00236500,Minneapolis College Of Art & Design,Minnesota,807630,1268917,2217000,4293547,0
PA,01205000,Rosedale Technical College,Pennsylvania,842493,1252706,2192000,4287199,0
AL,02341000,Fortis College,Alabama,4282458,0,0,4282458,0
MI,00795000,West Shore Community College,Michigan,564751,1225927,2491000,4281678,0
WV,00383100,Wheeling University,West Virginia,766653,1274648,2240000,4281301,0
ME,00576000,Northern Maine Community College,Maine,655429,1320610,2304000,4280039,0
OR,00321700,Reed College,Oregon,842657,1237124,2197000,4276781,579820000
ME,00205100,Saint Joseph'S College,Maine,649094,1306280,2315000,4270374,0
PW,01100900,Palau Community College,Palau,759490,1283232,2225000,4267722,0
FL,03079800,George T. Baker Aviation Technical College,Florida,624978,1323182,2316000,4264160,0
MA,00215100,Benjamin Franklin Institute Of Technology,Massachusetts,814858,1256813,2190000,4261671,0
WY,00728900,Central Wyoming College,Wyoming,578937,1328069,2347000,4254006,0
IN,00179900,Goshen College,Indiana,792911,1257733,2203000,4253644,113643000
CA,00125200,Hope International University,California,681856,1229636,2335000,4246492,0
OH,00313400,Ursuline College,Ohio,673311,1294301,2275000,4242612,0
MA,00632400,Laboure College,Massachusetts,661421,1298168,2268000,4227589,0
VA,00370300,Bluefield College,Virginia,691152,1286307,2247000,4224459,0
ME,00203300,University Of Maine - Presque Isle,Maine,610998,1310251,2302000,4223249,0
SC,00345300,University Of South Carolina - Lancaster,South Carolina,570863,1322097,2324000,4216960,0
CA,00117000,Claremont Mckenna College,California,855579,1204979,2133000,4193558,865475000
MS,00239800,Blue Mountain College,Mississippi,784621,1241220,2162000,4187841,0
ID,00161700,College Of Idaho (The),Idaho,809015,1222831,2146000,4177846,0
FL,03957400,New College Of Florida,Florida,837170,1196735,2143000,4176905,0
KS,00193300,Mcpherson College,Kansas,795375,1229981,2150000,4175356,47125000
NC,00291200,Brevard College,North Carolina,782339,1235952,2155000,4173291,28160000
IA,00186200,Ellsworth Community College,Iowa,715943,1253256,2188000,4157199,0
GA,00348400,Covenant College,Georgia,822751,1203174,2116000,4141925,42681000
NC,00297900,Warren Wilson College,North Carolina,776538,1224969,2140000,4141507,51270000
VA,00371500,Hollins University,Virginia,799714,1184387,2152000,4136101,182729000
SC,00932200,Williamsburg Technical College,South Carolina,589306,1235202,2307000,4131508,0
NV,00697700,Great Basin College,Nevada,470059,1323265,2338000,4131324,0
MA,00214500,Eastern Nazarene College,Massachusetts,761413,1225868,2143000,4130281,0
MI,00226400,Gogebic Community College,Michigan,661272,1259603,2201000,4121875,0
AR,01286000,Arkansas Northeastern College,Arkansas,566883,1289032,2262000,4117915,0
MN,00400900,Mesabi Range College,Minnesota,561010,1289340,2263000,4113350,0
IN,00184400,Wabash College,Indiana,810923,1197190,2098000,4106113,344252000
NC,00294800,Montreat College,North Carolina,735993,1225163,2142000,4103156,0
CA,00131900,"University Of California, San Francisco",California,867955,1133080,2095000,4096035,0
SC,00343800,Medical University Of South Carolina,South Carolina,937694,1114732,2042000,4094426,375593000
MI,00469200,Dorsey School Of Business,Michigan,4088414,0,0,4088414,0
HI,00161400,Kauai Community College,Hawaii,535684,1285285,2259000,4079969,0
IA,00185700,Southwestern Community College,Iowa,587388,1264937,2224000,4076325,0
MO,00908900,Hannibal - Lagrange University,Missouri,759488,1196420,2091000,4046908,0
NC,00798600,Halifax Community College,North Carolina,616040,1241708,2175000,4032748,0
NC,00964600,Piedmont Community College,North Carolina,569586,1256023,2202000,4027609,0
TX,04131700,Southwest University At El Paso,Texas,4026674,0,0,4026674,0
AZ,00711300,Arizona Christian University,Arizona,747009,1188662,2074000,4009671,0
IN,00183500,Saint Mary Of The Woods College,Indiana,637917,1227989,2143000,4008906,0
MA,00215000,Fisher College,Massachusetts,496691,1265283,2245000,4006974,97743000
OH,00398200,Cleveland Institute Of Art (The),Ohio,801788,1162031,2026000,3989819,0
MI,00226300,Glen Oaks Community College,Michigan,576681,1232639,2167000,3976320,0
MS,00241400,Millsaps College,Mississippi,761840,1161398,2050000,3973238,0
NE,00256300,Union College,Nebraska,757995,1167914,2047000,3972909,0
TX,03422300,Milan Institute,Texas,3963075,0,0,3963075,0
CA,01290700,Lake Tahoe Community College,California,348926,1290394,2322000,3961320,0
IA,00185200,Clarke University,Iowa,768683,1155469,2032000,3956152,29340000
TN,00351100,Milligan College,Tennessee,742753,1160607,2050000,3953360,0
SC,00342900,Columbia International University,South Carolina,676941,1183116,2080000,3940057,0
MI,00226500,Grace Christian University,Michigan,485111,1257228,2189000,3931339,0
PA,01099800,Pennsylvania Institute Of Technology,Pennsylvania,518726,1247621,2164000,3930347,0
OH,00301600,Bluffton University,Ohio,768698,1144619,2001000,3914317,0
IA,00187100,Iowa Wesleyan University,Iowa,699320,1171539,2042000,3912859,0
NY,00271000,Cooper Union For The Advancement Of Science & Art (The),New York,766505,1110434,2033000,3909939,0
FL,02524000,Sunstate Academy,Florida,814778,1435284,1656000,3906062,0
WA,00380300,Whitman College,Washington,764766,1128146,2009000,3901912,565256000
VA,00915900,Paul D. Camp Community College,Virginia,512617,1227213,2154000,3893830,0
PR,02569400,Escuela De Artes Plasticas Y Diseño De Puerto Rico,Puerto Rico,686208,1170824,2034000,3891032,0
NY,00861400,Rabbinical College Bobover Yeshiva Bnei Zion,New York,751000,1148403,1988000,3887403,0
NH,00257200,Colby-Sawyer College,New Hampshire,779605,1128568,1977000,3885173,39449000
TN,00353600,Bryan College,Tennessee,579257,1199750,2106000,3885007,0
PR,01194000,Instituto Comercial De Puerto Rico Junior College,Puerto Rico,3879773,0,0,3879773,0
FL,03003600,William T Mcfatter Technical College,Florida,603976,1180478,2083000,3867454,0
FL,00560800,Traviss Technical College,Florida,644793,1173090,2038000,3855883,0
TN,00535400,Tennessee College Of Applied Technology-Jackson,Tennessee,510365,1124050,2208000,3842415,0
CA,04142600,Touro University,California,797347,1069020,1975000,3841367,0
AZ,02100600,Carrington College,Arizona,3823185,0,0,3823185,0
KS,00194500,Sterling College,Kansas,662915,1151312,2008000,3822227,0
MO,00252300,Westminster College,Missouri,768643,1111314,1942000,3821957,0
PA,00335200,Philadelphia College Of Osteopathic Medicine,Pennsylvania,863192,1038054,1919000,3820246,417899000
FL,00560500,Pinellas Technical College - Clearwater Campus,Florida,527113,1190438,2095000,3812551,0
ND,00298900,Dickinson State University,North Dakota,640093,1148421,2024000,3812514,0
PA,00336000,Rosemont College,Pennsylvania,653142,1142284,2004000,3799426,0
CA,00753100,Academy Of Art University,California,3791776,0,0,3791776,0
IA,01230000,Palmer College Of Chiropractic,Iowa,809390,1049646,1932000,3791036,58825000
NY,00477600,Central Yeshiva Tomchei Tmimim Lubavitz,New York,743134,1111506,1934000,3788640,0
KY,00195800,Brescia University,Kentucky,504094,1196232,2086000,3786326,0
WI,00538400,Nicolet Area Technical College,Wisconsin,484116,1192563,2092000,3768679,0
CA,04037300,Los Angeles Film School (The),California,3766527,0,0,3766527,0
FL,03346300,Academy For Nursing And Health Occupations,Florida,541389,1174616,2040000,3756005,0
AR,02111100,University Of Arkansas Community College Rich Mountain,Arkansas,542149,1170671,2043000,3755820,0
FL,00755800,Fort Myers Technical College,Florida,507574,1134896,2113000,3755470,0
FL,02228300,Lake Technical College,Florida,568563,1157066,2027000,3752629,0
NC,01119700,Mayland Community College,North Carolina,588968,1146354,2014000,3749322,0
IL,02168600,East-West University,Illinois,638436,1135709,1965000,3739145,0
PA,00331700,Cheyney University Of Pennsylvania,Pennsylvania,663615,1044814,2030000,3738429,0
LA,02600900,Aveda Arts & Sciences Institute Covington,Louisiana,3712040,0,0,3712040,0
KS,00194000,Southwestern College,Kansas,490411,1166646,2044000,3701057,0
AR,00108800,Lyon College,Arkansas,680216,1096447,1913000,3689663,0
CA,00123600,Menlo College,California,744390,1064287,1864000,3672677,0
PR,02189100,Cem College,Puerto Rico,3669368,0,0,3669368,0
NH,00529100,White Mountains Community College,New Hampshire,488503,1152186,2017000,3657689,0
SD,00346100,Dakota Wesleyan University,South Dakota,641844,1094081,1918000,3653925,0
TX,00851000,Eastfield College,Texas,3649693,0,0,3649693,0
CA,02330500,Laguna College Of Art And Design,California,661479,1081100,1892000,3634579,0
FL,03661400,South Florida Institute Of Technology,Florida,3625271,0,0,3625271,0
NC,00808500,Mcdowell Technical Community College,North Carolina,527975,1113327,1953000,3594302,0
FL,03127900,Osceola Technical College,Florida,590003,1094090,1908000,3592093,0
FL,00558600,Lindsey Hopkins Technical College,Florida,501691,1119239,1967000,3587930,0
TN,00493800,South College,Tennessee,3576321,0,0,3576321,0
GA,00159700,Truett Mcconnell University,Georgia,489215,1105771,1971000,3565986,0
CO,02117500,Naropa University,Colorado,656811,1053383,1853000,3563194,0
GA,04206400,Helms College,Georgia,602995,1077607,1869000,3549602,0
IL,00980000,Rush University,Illinois,683762,1008068,1845000,3536830,620253000
CA,01287200,North-West College,California,3525534,0,0,3525534,0
TX,02098300,Western Technical College,Texas,3503977,0,0,3503977,0
LA,03480300,Fortis College,Louisiana,3493748,0,0,3493748,0
ND,02242900,United Tribes Technical College,North Dakota,339952,1151040,1995000,3485992,0
OH,00648900,Christ College Of Nursing And Health Sciences,Ohio,567902,1060598,1852000,3480500,0
OH,00304100,Defiance College,Ohio,662680,1026944,1790000,3479624,19129000
CA,04169800,Gurnick Academy Of Medical Arts,California,3477356,0,0,3477356,0
OH,03071900,Mount Carmel College Of Nursing,Ohio,605611,1029901,1837000,3472512,0
CO,00135500,Lamar Community College,Colorado,588420,1049005,1835000,3472425,0
TN,00535300,Tennessee College Of Applied Technology-Livingston,Tennessee,479769,1082755,1905000,3467524,0
CT,00139300,Mitchell College,Connecticut,616528,1036072,1814000,3466600,0
KS,00193800,Pratt Community College,Kansas,518364,1065589,1876000,3459953,0
MO,00251200,Stephens College,Missouri,668976,1014615,1771000,3454591,0
TN,00402600,Tennessee College Of Applied Technology - Crossville,Tennessee,499909,1069622,1884000,3453531,0
MO,00252400,William Jewell College,Missouri,707592,989524,1739000,3436116,0
OR,00318900,Clatsop Community College,Oregon,444841,1078746,1911000,3434587,0
GA,00159600,Toccoa Falls College,Georgia,481239,1067910,1880000,3429149,0
TX,00356800,Frank Phillips College,Texas,488436,1065020,1871000,3424456,0
VA,00371300,Hampden Sydney College,Virginia,679908,988698,1749000,3417606,0
GA,00160000,Wesleyan College,Georgia,587801,1027993,1801000,3416794,0
MO,00638900,Goldfarb School Of Nursing At Barnes-Jewish College,Missouri,669542,989079,1745000,3403621,0
NY,00290100,Wells College,New York,623035,1014898,1765000,3402933,0
KS,00190100,Allen County Community College,Kansas,416499,1076217,1909000,3401716,0
OH,00941200,Fortis College,Ohio,3398488,0,0,3398488,0
CA,02270600,Life Pacific University,California,606084,1017845,1772000,3395929,0
KS,00191100,Colby Community College,Kansas,469448,1052247,1863000,3384695,0
NM,02511000,Southwestern Indian Polytechnic Institute,New Mexico,593278,1017848,1770000,3381126,0
FL,03103900,Marion Technical College,Florida,541724,1034079,1803000,3378803,0
TN,00528300,Tennessee College Of Applied Technology - Newbern,Tennessee,571359,961675,1839000,3372034,0
VA,00373400,Randolph College,Virginia,664874,984559,1721000,3370433,0
OK,02052700,Northeast Technology Center,Oklahoma,456375,1037246,1867000,3360621,0
WI,00387500,Northland College,Wisconsin,636542,992151,1731000,3359693,0
NE,00640400,Nebraska Methodist College Of Nursing & Allied Health,Nebraska,557892,1011693,1779000,3348585,0
NC,00943000,Tri-County Community College,North Carolina,522349,1026395,1797000,3345744,0
UT,02115400,Bridgerland Technical College,Utah,411631,1053906,1874000,3339537,0
NH,00755500,Lakes Region Community College,New Hampshire,439512,1044695,1848000,3332207,0
CA,03062700,Platt College,California,3330094,0,0,3330094,0
TX,02117100,Art Institute Of Houston (The),Texas,3313919,0,0,3313919,0
CA,00125900,Palo Verde College,California,349166,1038714,1910000,3297880,0
NJ,03666300,Pillar College,New Jersey,562480,996324,1736000,3294804,0
NY,00283900,State University Of New York Downstate Medical Center,New York,658028,927377,1688000,3273405,0
PA,00531000,Pittsburgh Institute Of Aeronautics,Pennsylvania,458946,1013613,1780000,3252559,0
GA,00155500,Thomas University,Georgia,375530,1037983,1836000,3249513,29605000
AL,03010800,Fortis Institute,Alabama,3246774,0,0,3246774,0
FL,01082600,Tom P. Haney Technical Center,Florida,539960,988396,1717000,3245356,0
SD,00346500,Mount Marty College,South Dakota,489509,986775,1754000,3230284,0
IL,00167800,Eureka College,Illinois,624909,947882,1654000,3226791,0
PA,00330600,University Of Valley Forge,Pennsylvania,599907,955627,1670000,3225534,0
WV,00380800,Bethany College,West Virginia,582649,962066,1679000,3223715,0
KS,01050300,Wichita Technical Institute,Kansas,3213488,0,0,3213488,0
FL,00148500,College Of The Florida Keys (The),Florida,481856,989069,1740000,3210925,0
PA,00267000,Clarks Summit University,Pennsylvania,596633,942626,1666000,3205259,0
MO,00250400,St. Louis College Of Pharmacy,Missouri,678296,908540,1618000,3204836,144776000
IN,00182400,Oakland City University,Indiana,465821,981448,1744000,3191269,0
IA,00460000,Northwest Iowa Community College,Iowa,422535,996810,1771000,3190345,0
SC,00492700,University Of South Carolina - Union,South Carolina,457913,986521,1740000,3184434,0
GA,00927000,Art Institute Of Atlanta (The),Georgia,3179031,0,0,3179031,0
FL,02511700,Ridge Technical College,Florida,516450,970771,1690000,3177221,0
CA,03067500,Institute Of Technology,California,3164257,0,0,3164257,0
WA,01231500,Cornish College Of The Arts,Washington,632813,915631,1613000,3161444,0
AK,00106500,University Of Alaska Southeast,Alaska,372939,1001982,1784000,3158921,0
CA,00117200,Pitzer College,California,625861,913259,1619000,3158120,144365000
PR,02297700,Automeca Technical College,Puerto Rico,3157261,0,0,3157261,0
CA,03971300,American Career College,California,3157248,0,0,3157248,0
CA,04169700,Unitek College,California,3157044,0,0,3157044,0
VA,00499600,Dabney S Lancaster Community College,Virginia,444563,981191,1725000,3150754,0
MN,00236100,Martin Luther College,Minnesota,531043,945500,1670000,3146543,0
MN,00238300,Crown College,Minnesota,491090,960841,1686000,3137931,0
FL,00560700,Suncoast Technical College,Florida,425821,971627,1739000,3136448,0
PA,02183000,Orleans Technical College,Pennsylvania,582950,931256,1620000,3134206,0
MO,00248500,Midwestern Baptist Theological Seminary,Missouri,466997,948700,1713000,3128697,0
MO,02068200,Cox College,Missouri,492010,955693,1678000,3125703,0
OH,04074300,Hondros College Of Nursing,Ohio,3120827,0,0,3120827,0
CT,02106600,American Institute,Connecticut,3113907,0,0,3113907,0
TN,00537900,Tennessee College Of Applied Technology-Shelbyville,Tennessee,547306,931766,1631000,3110072,0
MD,01001400,Garrett College,Maryland,504992,947671,1655000,3107663,0
NY,02599400,New York College Of Health Professions,New York,537043,930830,1629000,3096873,0
IL,00171600,Maccormac College,Illinois,382008,992573,1720000,3094581,0
OH,02190700,Fortis College,Ohio,3093935,0,0,3093935,0
FL,02326900,Sunstate Academy,Florida,478081,947773,1656000,3081854,0
LA,00200300,Centenary College Of Louisiana,Louisiana,608956,890394,1579000,3078350,0
CO,00998100,Morgan Community College,Colorado,411258,966838,1698000,3076096,0
GA,00155700,Brewton Parker College,Georgia,449184,950942,1665000,3065126,0
TX,00976800,University Of North Texas Health Science Center At Fort Worth,Texas,687698,832399,1539000,3059097,0
OK,00996500,Canadian Valley Technology Center School District No. 6,Oklahoma,601347,872268,1583000,3056615,0
KY,00196500,Kentucky Christian University,Kentucky,531102,919413,1605000,3055515,0
NH,00756000,River Valley Community College,New Hampshire,384684,965201,1705000,3054885,0
IL,00174600,Robert Morris University Illinois,Illinois,3052761,0,0,3052761,0
SC,00343200,Erskine College,South Carolina,587364,894189,1570000,3051553,0
WY,00392900,Eastern Wyoming College,Wyoming,420524,945262,1685000,3050786,0
CA,00121700,Lassen College,California,335004,963037,1733000,3031041,0
KS,00526500,North Central Kansas Technical College,Kansas,490545,917405,1613000,3020950,0
NM,00996200,Luna Community College,New Mexico,399419,948067,1673000,3020486,0
PA,02114200,Johnson College,Pennsylvania,559569,897027,1561000,3017596,0
TX,01001900,University Of Texas Southwestern Medical Center (The),Texas,602606,843650,1560000,3006256,0
IN,00183400,Calumet College Of Saint Joseph,Indiana,562456,886885,1554000,3003341,0
WA,01302200,City University Of Seattle,Washington,432868,918942,1651000,3002810,0
VT,00368200,Bennington College,Vermont,592763,869044,1534000,2995807,0
FL,01323400,Lorenzo Walker Technical College,Florida,492820,858353,1634000,2985173,0
FL,02524200,Robert Morgan Educational Center And Technical College,Florida,447181,917050,1616000,2980231,0
MI,02099700,Ross Medical Education Center,Michigan,2973094,0,0,2973094,0
NY,01258900,Erie 1 Board Of Cooperative Educational Services,New York,577270,868446,1524000,2969716,0
FL,02307400,George Stone Technical College,Florida,446933,916920,1605000,2968853,0
OR,04151900,Columbia Gorge Community College,Oregon,375638,938681,1654000,2968319,0
PR,01081900,Conservatorio De Música De Puerto Rico,Puerto Rico,548486,878541,1531000,2958027,0
OK,00318000,Southwestern Christian University,Oklahoma,534184,879278,1528000,2941462,0
KS,00194600,Tabor College,Kansas,525581,874230,1530000,2929811,0
CA,00120500,Golden Gate University,California,464148,871390,1580000,2915538,46828000
NV,00919200,Sierra Nevada College,Nevada,553670,852648,1508000,2914318,0
NY,02556700,Seminar L'Moros Bais Yaakov,New York,644413,829572,1439000,2912985,0
MO,00247700,A. T. Still University Of Health Sciences,Missouri,539820,831012,1536000,2906832,0
KY,00461900,Sullivan University,Kentucky,2903218,0,0,2903218,0
TX,00850300,Mountain View College,Texas,2902459,0,0,2902459,0
IL,00165900,Rosalind Franklin University Of Medicine And Science,Illinois,600592,807025,1492000,2899617,0
TN,03830300,Sae Institute Of Technology,Tennessee,2892306,0,0,2892306,0
CO,00135900,Colorado Northwestern Community College,Colorado,397997,898356,1593000,2889353,0
MI,00407100,Walsh College Of Accountancy & Business Administration,Michigan,422403,888354,1578000,2888757,9730000
MO,02202700,Ozark Christian College,Missouri,489464,871809,1521000,2882273,0
NY,01185900,Word Of Life Bible Institute,New York,506756,858197,1503000,2867953,0
ND,00300800,Valley City State University,North Dakota,452941,868060,1532000,2853001,0
TX,03612400,Valley Grande Institute For Academic Studies,Texas,422034,885308,1535000,2842342,0
AR,00110600,Williams Baptist University,Arkansas,528721,839882,1465000,2833603,0
KS,00190800,Central Christian College Of Kansas,Kansas,464984,861626,1506000,2832610,0
KS,00526700,Northwest Kansas Technical College,Kansas,479285,841008,1493000,2813293,0
AL,00569200,Reid State Technical College,Alabama,435328,866379,1508000,2809707,0
CA,00565500,Hacienda La Puente Adult Education,California,388304,853390,1559000,2800694,0
PA,02558700,Prism Career Institute,Pennsylvania,2799781,0,0,2799781,0
OK,00533900,Metro Technology Centers School District #22,Oklahoma,466807,836177,1491000,2793984,0
OH,00703500,Kettering College,Ohio,525294,817668,1451000,2793962,0
NY,00746800,School Of Visual Arts,New York,2793698,0,0,2793698,0
PA,02310800,Lancaster County Career And Technology Center,Pennsylvania,508099,824731,1454000,2786830,0
FL,02316200,Miami Lakes Educational Center And Technical College,Florida,362478,866414,1556000,2784892,0
OR,00320700,Pacific Northwest College Of Art,Oregon,456256,779482,1548000,2783738,0
NY,02219500,Mildred Elley,New York,2777967,0,0,2777967,0
NY,01201100,Talmudical Seminary Oholei Torah,New York,538150,818735,1420000,2776885,0
NY,03358300,Allen School,New York,2769386,0,0,2769386,0
WA,02180000,Northwest Indian College,Washington,403967,862256,1503000,2769223,0
FL,00887800,Miami International University Of Art & Design,Florida,2762168,0,0,2762168,0
NC,00296300,Southeastern Baptist Theological Seminary,North Carolina,347269,847381,1567000,2761650,0
CA,00122900,Southern California University Of Health Sciences,California,401546,832703,1518000,2752249,0
MN,00235000,Vermilion Community College,Minnesota,454539,830732,1460000,2745271,0
TN,00535600,Tennessee College Of Applied Technology - Hohenwald,Tennessee,261811,871170,1610000,2742981,0
CA,02128300,Institute For Business & Technology,California,2735892,0,0,2735892,0
CA,00673100,Casa Loma College,California,506509,739820,1488000,2734329,0
CA,00117400,Scripps College,California,546083,785174,1401000,2732257,375585000
NC,04206500,Mycomputercareer.Com,North Carolina,2727181,0,0,2727181,0
GA,03523300,Aviation Institute Of Maintenance,Georgia,2722482,0,0,2722482,0
VA,03709300,Edward Via Virginia College Of Osteopathic Medicine,Virginia,589803,747735,1382000,2719538,0
CT,02202500,New England Tractor Trailer Training School Of Connecticut,Connecticut,2717490,0,0,2717490,0
AL,03002500,J.F. Ingram State Technical College,Alabama,448264,822536,1443000,2713800,0
OK,01227200,Moore Norman Technology Center School District No. 17,Oklahoma,278987,862226,1558000,2699213,0
SD,02143700,Sinte Gleska University,South Dakota,385959,838117,1466000,2690076,0
VA,02541200,Stratford University,Virginia,2689835,0,0,2689835,0
NY,01015300,Helene Fuld College Of Nursing,New York,445514,816859,1426000,2688373,0
KY,04038300,Ata College,Kentucky,2684973,0,0,2684973,0
NY,00746500,American Academy Of Dramatic Arts,New York,533811,778823,1367000,2679634,0
SD,00346700,Presentation College,South Dakota,454681,807234,1410000,2671915,0
NE,00986200,Clarkson College,Nebraska,441901,806294,1419000,2667195,0
KS,00190500,Bethel College,Kansas,531372,777483,1358000,2666855,0
MA,00220100,Pine Manor College,Massachusetts,518912,782334,1363000,2664246,0
NY,00289200,United States Merchant Marine Academy,New York,569967,708815,1381000,2659782,0
MN,00233700,Bethany Lutheran College,Minnesota,471985,789349,1390000,2651334,44117000
IN,00178400,Ancilla Domini College,Indiana,492118,784978,1366000,2643096,0
VA,00376200,Virginia University Of Lynchburg,Virginia,357917,835545,1449000,2642462,0
NE,00639900,Bryan College Of Health Sciences,Nebraska,484417,780709,1377000,2642126,0
NY,00284000,State University Of New York Upstate Medical University,New York,519926,748378,1357000,2625304,0
KS,00526400,Flint Hills Technical College,Kansas,306504,829141,1487000,2622645,0
FL,02321200,Orange Technical College - Westside Campus,Florida,293856,834853,1490000,2618709,0
WI,02317200,Maranatha Baptist University,Wisconsin,410308,792518,1394000,2596826,0
FL,03230300,Okaloosa Technical College And Choice High School,Florida,393330,792866,1410000,2596196,0
CA,00125500,Pacific Oaks College,California,340238,815692,1434000,2589930,0
NC,00808700,Montgomery Community College,North Carolina,382976,799600,1401000,2583576,0
SC,00536300,Denmark Technical College,South Carolina,412522,787267,1376000,2575789,0
OK,00996800,Gordon Cooper Technology Center,Oklahoma,509679,746137,1319000,2574816,0
NY,00757300,Empire Beauty School,New York,2572614,0,0,2572614,0
AL,00102600,Marion Military Institute,Alabama,514237,742268,1307000,2563505,0
KS,00550000,Manhattan Area Technical College,Kansas,369841,790612,1399000,2559453,0
CA,00117100,Harvey Mudd College,California,516332,733506,1303000,2552838,328568000
SC,00342100,Bob Jones University,South Carolina,2552058,0,0,2552058,0
TX,445300,El Centro College,Texas,2550619,0,0,2550619,0
NH,03101300,Granite State College,New Hampshire,269441,819990,1438000,2527431,0
NY,00274200,Juilliard School (The),New York,524199,712263,1289000,2525462,0
ME,01167300,Maine College Of Art,Maine,507454,734222,1283000,2524676,0
MI,02533600,Ross Medical Education Center,Michigan,2521578,0,0,2521578,0
PA,00746900,Hussian College,Pennsylvania,2519530,0,0,2519530,0
NM,00209300,Saint John'S College,New Mexico,377298,544087,1594000,2515385,0
FL,02300900,Withlacoochee Technical College,Florida,403755,769396,1340000,2513151,0
TX,02331300,Interactive College Of Technology,Texas,2503478,0,0,2503478,0
MI,00232200,Finlandia University,Michigan,447690,748336,1304000,2500026,0
TX,02077400,North Lake College,Texas,2498181,0,0,2498181,0
CA,00121200,Humphreys University,California,398142,764036,1335000,2497178,0
FL,00752600,Florida Panhandle Technical College,Florida,378062,768153,1340000,2486215,0
ND,00300700,Williston State College,North Dakota,338809,772089,1360000,2470898,0
OR,00320600,Multnomah University,Oregon,433018,738474,1294000,2465492,0
MA,02231600,Mgh Institute Of Health Professions,Massachusetts,500795,687131,1271000,2458926,0
TN,02237900,Tennessee College Of Applied Technology-Paris,Tennessee,394967,752114,1310000,2457081,0
LA,03789300,Unitech Training Academy,Louisiana,2453939,0,0,2453939,0
NJ,02132300,Fortis Institute,New Jersey,2435661,0,0,2435661,0
NJ,00642100,Jfk Medical Center Muhlenberg Harold B. And Dorothy A. Snyder Schools,New Jersey,417854,733771,1281000,2432625,0
FL,00148200,Florida College,Florida,445256,722456,1264000,2431712,0
NE,00256700,York College,Nebraska,459315,716808,1251000,2427123,0
VA,00374800,Eastern Shore Community College,Virginia,338336,754006,1320000,2412342,0
IN,02140800,Martin University,Indiana,395736,735403,1277000,2408139,0
MI,02339700,Ross Medical Education Center,Michigan,2390068,0,0,2390068,0
FL,01254400,St. Johns County School District,Florida,308355,585637,1495000,2388992,0
NY,00726400,Mesivta Torah Vodaath Rabbinical Seminary,New York,459637,663172,1263000,2385809,0
NV,03838500,Northwest Career College,Nevada,2384152,0,0,2384152,0
CA,01203100,San Diego Christian College,California,421905,711004,1244000,2376909,0
CA,00950900,Charles A. Jones Career And Education Center,California,365709,733656,1275000,2374365,0
NV,02248200,Milan Institute Of Cosmetology,Nevada,2373948,0,0,2373948,0
NY,03129200,Rabbinical College Of Ohr Shimon Yisroel,New York,460264,694125,1219000,2373389,0
FL,03101900,Trinity Baptist College,Florida,421907,712214,1239000,2373121,0
CA,03108100,Summit College,California,2365247,0,0,2365247,0
VA,02342700,Fortis College,Virginia,2359780,0,0,2359780,0
OH,02263700,Miami Valley Career Technology Center,Ohio,244731,685943,1428000,2358674,0
MI,00224600,Cleary University,Michigan,384753,714577,1253000,2352330,0
IN,00726300,Holy Cross College,Indiana,469591,682060,1193000,2344651,0
MI,02060300,Miat College Of Technology,Michigan,2341441,0,0,2341441,0
PA,01054200,Empire Beauty School,Pennsylvania,2339199,0,0,2339199,0
ND,00299300,Mayville State University,North Dakota,312720,733724,1290000,2336444,0
MT,02510600,Blackfeet Community College,Montana,266062,753694,1311000,2330756,0
MT,00252700,University Of Providence,Montana,376995,705742,1245000,2327737,0
PR,00890200,Columbia Central University,Puerto Rico,2321653,0,0,2321653,0
OH,01099300,Hobart Institute Of Welding Technology,Ohio,485886,663262,1164000,2313148,0
NM,02146400,Institute Of American Indian & Alaska Native Culture & Artsdevelopment,New Mexico,342519,713431,1254000,2309950,0
CA,02531800,Paul Mitchell The School Costa Mesa,California,2289751,0,0,2289751,0
NY,00275900,Manhattan School Of Music,New York,441481,655621,1189000,2286102,0
TX,03422400,College Of Biblical Studies-Houston,Texas,203755,833405,1245000,2282160,0
TX,00661200,Covenant School Of Nursing And Allied Health,Texas,403823,681520,1194000,2279343,0
PA,00330000,Moore College Of Art And Design,Pennsylvania,441674,669083,1167000,2277757,0
CA,03590400,Ntma Training Centers Of Southern California,California,427969,672688,1170000,2270657,0
PA,02079400,Empire Beauty School,Pennsylvania,2268234,0,0,2268234,0
TN,00528000,Tennessee College Of Applied Technology - Covington,Tennessee,248249,524530,1495000,2267779,0
NM,00265000,University Of The Southwest,New Mexico,435854,663788,1166000,2265642,0
FL,02504600,Orange Technical College-Winter Park Campus,Florida,265697,711621,1286000,2263318,0
PR,02260800,Huertas College,Puerto Rico,2262464,0,0,2262464,0
NC,00861300,Roanoke Chowan Community College,North Carolina,353481,691315,1208000,2252796,0
ND,00299100,Lake Region State College,North Dakota,110878,371642,1768000,2250520,0
TN,01032600,Tennessee College Of Applied Technology - Harriman,Tennessee,411299,663406,1174000,2248705,0
IA,01111300,Maharishi International University,Iowa,408145,657539,1182000,2247684,0
TX,00494900,Baylor College Of Medicine,Texas,506003,610941,1129000,2245944,1301005000
KS,00192000,Hesston College,Kansas,444466,654430,1143000,2241896,0
RI,02584400,New England Tractor Trailer Training School Of Massachusetts,Rhode Island,2226771,0,0,2226771,0
AR,02073700,Northwest Technical Institute,Arkansas,437217,651865,1134000,2223082,0
MI,00817800,Empire Beauty School,Michigan,2219238,0,0,2219238,0
ND,02188200,Sitting Bull College,North Dakota,375048,669488,1164000,2208536,0
NY,02173200,Empire Beauty School,New York,2208217,0,0,2208217,0
WA,02242500,Bastyr University,Washington,501592,606942,1095000,2203534,0
PA,02495500,All-State Career School,Pennsylvania,2203255,0,0,2203255,0
ME,00923100,Washington County Community College,Maine,341449,678640,1182000,2202089,0
MI,02361500,Michigan Barber School,Michigan,447200,611486,1139000,2197686,0
NY,02170200,Albany Schoharie Schenectady Saratoga Boces Practical Nursing Program,New York,416996,650370,1127000,2194366,0
OH,02354200,Scioto County Career Technical Center,Ohio,419892,649101,1125000,2193993,0
NY,03181400,Merkaz Bnos,New York,403827,633910,1156000,2193737,0
NY,01014700,Western Suffolk Boces,New York,422592,644964,1126000,2193556,0
TX,02100200,Brookhaven College,Texas,2187307,0,0,2187307,0
TN,00946400,Tennessee College Of Applied Technology-Pulaski,Tennessee,263555,661864,1258000,2183419,0
FL,04146300,Fred K. Marchman Technical College,Florida,320269,673867,1179000,2173136,0
PA,00331100,Salus University,Pennsylvania,503656,586171,1083000,2172827,48896000
PR,02195800,Liceo De Arte Y Tecnología,Puerto Rico,2168379,0,0,2168379,0
CA,03067400,Baldwin Park Adult School,California,319015,657738,1189000,2165753,0
SC,00492300,Clinton College,South Carolina,233942,707265,1224000,2165207,0
MI,02180100,Ross Medical Education Center,Michigan,2164321,0,0,2164321,0
NY,04095300,King'S College (The),New York,396742,639724,1127000,2163466,0
TN,02157100,Concorde Career College,Tennessee,2155995,0,0,2155995,0
CA,02559400,Intercoast Colleges,California,2149757,0,0,2149757,0
TN,00528200,Tennessee College Of Applied Technology-Hartsville,Tennessee,318610,659236,1164000,2141846,0
OK,03367400,Community Care College,Oklahoma,2135245,0,0,2135245,0
FL,03158300,Cape Coral Technical College,Florida,358183,635804,1127000,2120987,0
AZ,01085800,Avalon School Of Cosmetology,Arizona,2120430,0,0,2120430,0
PA,00338600,Valley Forge Military College,Pennsylvania,385652,600069,1126000,2111721,0
AL,00102300,Judson College,Alabama,369009,632686,1100000,2101695,0
FL,02278800,Southern Technical College,Florida,2097167,0,0,2097167,0
CO,04177100,Pima Medical Institute,Colorado,2092022,0,0,2092022,0
NM,00265600,New Mexico Military Institute,New Mexico,415633,606810,1062000,2084443,0
MO,00247400,Kansas City University Of Medicine And Biosciences,Missouri,409399,587192,1085000,2081591,0
TN,01070000,Tennessee College Of Applied Technology-Jacksboro,Tennessee,365951,614625,1090000,2070576,0
KS,00191400,Donnelly College,Kansas,294832,645519,1130000,2070351,0
VA,02334400,Centura College,Virginia,2069211,0,0,2069211,0
FL,03696400,Saber College,Florida,382767,539191,1147000,2068958,0
WV,00381900,Ohio Valley University,West Virginia,405760,577221,1076000,2058981,0
MA,03570500,Northpoint Bible College,Massachusetts,423110,596720,1039000,2058830,0
OK,00314700,Bacone College,Oklahoma,509457,565617,983000,2058074,0
GA,00154500,Andrew College,Georgia,355871,617316,1073000,2046187,0
FL,02513200,Orange Technical College - Orlando Campus,Florida,255268,642991,1143000,2041259,0
MA,02063000,Montserrat College Of Art,Massachusetts,375198,605741,1057000,2037939,0
PR,03115900,Trinity College Of Puerto Rico,Puerto Rico,394678,599261,1038000,2031939,0
CA,02338500,Glendale Career College,California,2025197,0,0,2025197,0
MI,01262700,Thomas M. Cooley Law School,Michigan,405235,566834,1048000,2020069,0
MD,00209200,St. John'S College,Maryland,398355,571777,1049000,2019132,0
PA,02529800,Wilkes Barre Area Career And Technical Center Practical Nursing Prgm,Pennsylvania,335061,601805,1080000,2016866,0
IA,00185500,Des Moines University - Osteopathic Medical Center,Iowa,422290,557988,1032000,2012278,0
PA,01260600,Empire Beauty School,Pennsylvania,2008780,0,0,2008780,0
FL,03373300,Beacon College,Florida,405430,582246,1018000,2005676,0
NY,01167000,Yeshiva Of Nitra Rabbinical College,New York,386639,589386,1022000,1998025,0
PA,00966400,Empire Beauty School,Pennsylvania,1988069,0,0,1988069,0
CA,01215400,California Institute Of Integral Studies,California,352356,577600,1050000,1979956,0
CT,01242500,Stone Academy,Connecticut,1976921,0,0,1976921,0
NY,01229300,Veeb Nassau County School Of Practical Nursing,New York,391740,578090,1003000,1972830,0
NJ,02523700,Ocean County Vocational - Technical Schools,New Jersey,380824,578987,1010000,1969811,0
OH,02246300,Ross Medical Education Center,Ohio,1965598,0,0,1965598,0
IL,00170800,Lincoln Christian University,Illinois,332245,592346,1041000,1965591,0
CA,04149700,Homestead Schools,California,309756,605232,1050000,1964988,0
WI,02453500,Medical College Of Wisconsin,Wisconsin,386216,552026,1020000,1958242,937909000
PR,03751300,Escuela Hotelera De San Juan,Puerto Rico,1955007,0,0,1955007,0
OH,02192100,Butler Technology And Career Development Schools,Ohio,292763,602897,1057000,1952660,0
FL,03035900,National Aviation Academy,Florida,1950415,0,0,1950415,0
IL,01071000,Capital Area Career Center,Illinois,371962,571192,989000,1932154,0
CA,01111200,Fashion Institute Of Design & Merchandising,California,1931729,0,0,1931729,0
AZ,02065300,Prescott College,Arizona,301297,589575,1036000,1926872,0
NY,01235800,Plaza College,New York,1926657,0,0,1926657,0
ME,00945900,Empire Beauty School,Maine,1925983,0,0,1925983,0
MN,01232800,Northwestern Health Sciences University,Minnesota,388538,543636,989000,1921174,0
VA,02175800,Centra College,Virginia,229579,610634,1070000,1910213,0
CA,01036500,Charles R. Drew University Of Medicine And Science,California,360477,554830,988000,1903307,0
TX,00357900,Jacksonville College,Texas,283804,585060,1034000,1902864,0
MN,00575900,Northwest Technical College - Bemidji,Minnesota,192242,618678,1088000,1898920,0
PA,02330300,Lebanon County Career And Technology Center,Pennsylvania,336929,504439,1053000,1894368,0
NY,02146000,Wayne - Finger Lakes Boces,New York,362846,560471,971000,1894317,0
AZ,02218800,Brookline College,Arizona,1890270,0,0,1890270,0
ND,00299500,Dakota College At Bottineau,North Dakota,234429,599989,1055000,1889418,0
UT,04121700,Dixie Technical College,Utah,202805,571074,1113000,1886879,0
NY,00751800,Apex Technical School,New York,1885989,0,0,1885989,0
TN,00535700,Tennessee College Of Applied Technology Crump,Tennessee,274881,559948,1051000,1885829,0
OK,00996400,Central Technology Center School District No. 3,Oklahoma,142537,623028,1120000,1885565,0
PA,00533500,Central Pennsylvania Institute Of Science And Technology,Pennsylvania,369675,552704,962000,1884379,0
FL,00752500,Riveroak Technical College,Florida,269159,532525,1082000,1883684,0
PR,03531300,Universidad Pentecostal Mizpa,Puerto Rico,301648,577248,1002000,1880896,0
OR,00320800,Bushnell University,Oregon,292486,574500,1011000,1877986,0
OH,00486600,Stautzenberger College,Ohio,1866592,0,0,1866592,0
FL,03079900,City College,Florida,292345,572965,994000,1859310,0
CA,02358000,Thomas Aquinas College,California,354873,519039,984000,1857912,0
NY,02179400,Eastern Suffolk Boces,New York,273593,524450,1056000,1854043,0
GA,03076300,Beulah Heights University,Georgia,295126,565763,992000,1852889,0
NM,03206300,Mesalands Community College,New Mexico,198978,593738,1060000,1852716,0
OK,02060800,"Meridian Technology Center, School District Number 16",Oklahoma,302793,556129,993000,1851922,0
VA,02140000,Riverside College Of Health Careers,Virginia,346191,546629,956000,1848820,0
OH,00648700,Aultman College Of Nursing And Health Sciences,Ohio,295724,563861,983000,1842585,0
OH,02117300,Great Oaks Career Campuses-Scarlet Oaks,Ohio,332099,528952,979000,1840051,0
TN,01216400,Tennessee College Of Applied Technology Ripley,Tennessee,226994,470019,1140000,1837013,0
PA,00657700,Upmc Shadyside,Pennsylvania,345358,542395,949000,1836753,0
KY,03885300,Employment Solutions,Kentucky,275569,483506,1074000,1833075,0
MO,03068600,Special School District Of St. Louis County,Missouri,333269,534788,961000,1829057,0
FL,03411400,International Training Careers,Florida,397293,522735,904000,1824028,0
TX,03426300,College Of Health Care Professions (The),Texas,1823842,0,0,1823842,0
MA,00219400,New England Conservatory Of Music,Massachusetts,367317,520449,934000,1821766,0
NY,02093700,Long Island Business Institute,New York,1821234,0,0,1821234,0
CA,03639300,West Coast Ultrasound Institute,California,1805882,0,0,1805882,0
IL,00624000,Saint Francis Medical Center College Of Nursing,Illinois,318356,538606,946000,1802962,0
TX,00356200,Dallas Theological Seminary,Texas,306745,523837,969000,1799582,0
PA,00322800,Bryn Athyn College Of The New Church,Pennsylvania,348922,527749,922000,1798671,0
MO,01320800,Baptist Bible College,Missouri,360668,568398,869000,1798066,0
PA,02127400,Yti Career Institute,Pennsylvania,1793845,0,0,1793845,0
NJ,04131100,Yeshiva Toras Chaim,New Jersey,347751,527203,917000,1791954,0
NY,01302600,Machzikei Hadath Rabbinical College,New York,346953,528178,915000,1790131,0
AZ,01168900,Refrigeration School (The),Arizona,1786314,0,0,1786314,0
CA,00116900,Claremont Graduate University,California,295107,522077,966000,1783184,186766000
OH,00649400,Good Samaritan College Of Nursing And Health Science,Ohio,270661,550028,961000,1781689,0
NY,00278400,New York Medical College,New York,374257,493127,912000,1779384,83043000
NJ,00860900,Rabbinical College Of America,New Jersey,347256,520890,911000,1779146,0
FL,03903500,Southern Technical College,Florida,1776085,0,0,1776085,0
MO,00245800,Cottey College,Missouri,334857,525514,915000,1775371,110200000
CA,03814400,Soka University Of America,California,351126,511076,912000,1774202,0
OK,01071700,Great Plains Technology Center School District Number 9,Oklahoma,353682,517164,899000,1769846,0
OH,04224300,Valor Christian College,Ohio,294534,546901,927000,1768435,0
MT,02610900,Stone Child College,Montana,216798,547688,1000000,1764486,0
NJ,02192200,Thomas Edison State University,New Jersey,17249,633035,1113000,1763284,0
MD,00143600,Capitol Technology University,Maryland,288665,531807,936000,1756472,0
GA,01077100,Gupton-Jones College Of Funeral Service,Georgia,275886,538259,933000,1747145,0
TN,00535200,Tennessee College Of Applied Technology-Mckenzie,Tennessee,321987,495548,927000,1744535,0
MT,00252800,Miles Community College,Montana,246778,541465,953000,1741243,0
CA,04118800,New York Film Academy,California,1739271,0,0,1739271,0
OH,02562300,Apollo Career Center,Ohio,168199,544541,1026000,1738740,0
CA,04193700,John Paul The Great Catholic University,California,343805,506092,886000,1735897,0
PR,02335500,Theological University Of The Caribbean,Puerto Rico,281192,525906,919000,1726098,0
NY,01054900,Kehilath Yakov Rabbinical Seminary,New York,334422,507413,884000,1725835,0
NJ,03424500,New Community Career And Technical Institute,New Jersey,289766,475626,956000,1721392,0
PA,01086000,Greater Altoona Career & Technology Center,Pennsylvania,291116,520740,906000,1717856,0
NY,03000100,Yeshiva Gedolah Imrei Yosef D'Spinka,New York,326856,508501,880000,1715357,0
TN,00535800,Tennessee College Of Applied Technology - Athens,Tennessee,246105,531907,937000,1715012,0
MO,04255700,Bolivar Technical College,Missouri,240473,537712,935000,1713185,0
CA,00120000,Fuller Theological Seminary,California,293342,497198,919000,1709540,0
KS,00549900,Salina Area Technical College,Kansas,203959,539924,964000,1707883,0
VA,01033800,Eastern Virginia Medical School,Virginia,329653,482539,892000,1704192,107959000
OH,02189000,Mid-East Career And Technology Centers - Adult Education,Ohio,362414,490347,851000,1703761,0
IL,02068100,Adler University,Illinois,260680,502259,929000,1691939,0
VT,00368600,Goddard College,Vermont,320334,497499,874000,1691833,0
FL,03123900,Southeastern College,Florida,1689659,0,0,1689659,0
MI,02618400,Michigan Career And Technical Institute,Michigan,238067,526316,921000,1685383,0
OH,01088000,Chatfield College,Ohio,260540,519257,903000,1682797,0
MA,00974700,Gordon Conwell Theological Seminary,Massachusetts,267766,495574,917000,1680340,0
OK,00834300,Autry Technology Center District No.15,Oklahoma,307354,493832,877000,1678186,0
CA,02309500,Clovis Adult Education,California,166012,435456,1074000,1675468,0
MI,03066600,Bay Mills Community College,Michigan,222497,528866,922000,1673363,0
PR,02163300,Universidad Central Del Caribe,Puerto Rico,305084,494244,872000,1671328,0
CO,00887100,Concorde Career College,Colorado,1667137,0,0,1667137,0
IA,00712100,Faith Baptist Bible College & Theological Seminary,Iowa,297034,496725,869000,1662759,0
WV,04119000,Eastern West Virginia Community & Technical College,West Virginia,211888,524164,918000,1654052,0
IA,03069100,Allen College,Iowa,282895,490373,871000,1644268,0
IL,00754900,Coyne College,Illinois,1641135,0,0,1641135,0
NY,02506000,Associated Beth Rivkah Schools,New York,284824,495633,859000,1639457,0
OH,03015300,Ehove Career Center,Ohio,228724,513389,896000,1638113,0
AZ,03572300,East Valley Institute Of Technology,Arizona,236123,503990,897000,1637113,0
FL,04146200,Emerald Coast Technical College,Florida,305110,484527,847000,1636637,0
OH,02272700,Columbiana County Vocational School District,Ohio,242978,506736,878000,1627714,0
TX,03516300,King'S University (The),Texas,274750,490625,862000,1627375,0
NC,03104200,Carolinas College Of Health Sciences,North Carolina,268630,489746,864000,1622376,0
FL,02297000,Charlotte Technical College,Florida,248791,489765,883000,1621556,0
NY,00740100,Mandl School,New York,1620451,0,0,1620451,0
CA,02075800,Southern California Institute Of Architecture (The),California,339620,458145,822000,1619765,0
OR,04194900,Tillamook Bay Community College,Oregon,315778,472016,831000,1618794,0
CA,03427500,University Of Antelope Valley,California,1613796,0,0,1613796,0
TX,02555400,University Of Texas Md Anderson Cancer Center,Texas,285840,478904,844000,1608744,0
ME,01138500,College Of The Atlantic,Maine,303385,473835,830000,1607220,0
KY,04178000,Simmons College Of Kentucky,Kentucky,240805,499431,866000,1606236,0
CA,02542300,National Holistic Institute,California,1602448,0,0,1602448,0
NY,02505800,Yeshiva Karlin Stolin,New York,306121,462864,830000,1598985,0
NY,00702600,Icahn School Of Medicine At Mount Sinai,New York,336074,442990,819000,1598064,0
MN,01173200,Mayo Clinic College Of Medicine And Science,Minnesota,328294,446290,821000,1595584,0
WV,02073400,Carver Career And Technical Education Center,West Virginia,307983,470190,816000,1594173,0
TN,00971000,Tennessee College Of Applied Technology - Oneida/Huntsville,Tennessee,213467,460696,920000,1594163,0
FL,02159600,Baptist College Of Florida (The),Florida,262085,483725,846000,1591810,0
MA,00964500,Bard College At Simon'S Rock,Massachusetts,312339,463190,815000,1590529,0
TN,02092800,Tennessee College Of Applied Technology Whiteville,Tennessee,203162,461879,925000,1590041,0
FL,02601600,Brewster Technical College,Florida,179902,507564,898000,1585466,0
PR,02343600,Institute Of Beauty Careers,Puerto Rico,1583438,0,0,1583438,0
CO,01014800,Colorado Technical University,Colorado,1581179,0,0,1581179,0
MT,02286600,Little Big Horn College,Montana,260189,479458,839000,1578647,0
AZ,03784400,Tohono O'Odham Community College,Arizona,199279,508878,870000,1578157,0
GA,02583000,Gwinnett College,Georgia,1577669,0,0,1577669,0
PA,00656500,Reading Hospital School Of Health Sciences,Pennsylvania,269244,475342,833000,1577586,0
PA,01000600,Greater Johnstown Area Vocational Technical School,Pennsylvania,255046,481436,837000,1573482,0
OR,00319100,Concordia University,Oregon,1572272,0,0,1572272,0
MA,00396600,Boston Architectural College,Massachusetts,279755,460236,819000,1558991,11822000
NY,04117100,E.D.P. School,New York,259277,475810,823000,1558087,0
FL,04162500,Hollywood Institute Of Beauty Careers,Florida,1554527,0,0,1554527,0
MA,00633100,Lawrence Memorial Hospital School Of Nursing,Massachusetts,238782,478023,837000,1553805,0
IA,02328900,Emmaus Bible College,Iowa,313744,451587,787000,1552331,0
MA,00975600,University Of Massachusetts Medical School,Massachusetts,310132,435006,804000,1549138,0
CA,02138300,Palo Alto University,California,303711,438443,796000,1538154,0
PA,02536600,Commonwealth Technical Institute,Pennsylvania,268150,460825,807000,1535975,0
CA,03113600,Southern California Institute Of Technology,California,1535401,0,0,1535401,0
CA,02262400,Yeshiva Ohr Elchonon Chabad - West Coast Talmudical Seminary,California,286933,453332,788000,1528265,0
NC,00647700,Cabarrus College Of Health Sciences,North Carolina,253120,462682,812000,1527802,0
OH,00813200,Toledo Public Schools Adult And Continuing Education,Ohio,219334,471735,832000,1523069,0
MO,02361600,Concorde Career College,Missouri,1519727,0,0,1519727,0
PA,02282500,Lenape Technical School,Pennsylvania,267853,457121,793000,1517974,0
VA,00372600,American National University,Virginia,1508237,0,0,1508237,0
VA,00374200,Sweet Briar College,Virginia,272489,448436,786000,1506925,0
OH,01092300,Union Institute & University,Ohio,187502,476989,836000,1500491,0
OK,01026600,Randall University,Oklahoma,250159,455448,793000,1498607,0
CO,03006300,Ibmc College,Colorado,1497661,0,0,1497661,0
PA,01162100,Automotive Training Center,Pennsylvania,1497626,0,0,1497626,0
CA,00394800,San Francisco Art Institute,California,283166,438533,773000,1494699,0
ND,02236500,Cankdeska Cikana (Little Hoop) Community College,North Dakota,216968,466352,810000,1493320,0
CA,03029600,Pomona Adult School,California,245993,453341,787000,1486334,0
AK,00106100,Alaska Pacific University,Alaska,254627,445957,784000,1484584,0
TX,02230500,Ogle School Hair Skin Nails,Texas,1482600,0,0,1482600,0
NY,01182100,Yeshivath Zichron Moshe,New York,287275,435215,759000,1481490,0
CA,03695300,Community Enhancement Services,California,267036,443325,768000,1478361,0
LA,00806700,Louisiana State University Health Sciences Center In Shreveport,Louisiana,316992,407364,750000,1474356,0
CA,04228100,High Desert Medical College,California,1472341,0,0,1472341,0
MN,04227800,Bethany Global University,Minnesota,261065,438908,767000,1466973,0
IL,02117400,Beck School Of Practical Nursing,Illinois,274401,402122,782000,1458523,0
TX,02548800,South Texas Vocational Technical Institute,Texas,1455120,0,0,1455120,0
KY,00195300,Asbury Theological Seminary,Kentucky,260367,419058,775000,1454425,150440000
OH,00301100,Art Academy Of Cincinnati,Ohio,247921,440321,766000,1454242,0
SD,00405700,National American University,South Dakota,1453446,0,0,1453446,0
PA,02269900,Pennsylvania College Of Art & Design,Pennsylvania,275900,427928,746000,1449828,0
NY,00267700,Brooklyn Law School,New York,251110,417427,772000,1440537,0
WI,03125100,College Of Menominee Nation,Wisconsin,174970,461052,802000,1438022,0
NC,00703100,Pamlico Community College,North Carolina,222221,440805,774000,1437026,0
TN,03001800,Welch College,Tennessee,230280,437532,767000,1434812,0
NM,01300500,Olympian Academy Of Cosmetology,New Mexico,1430238,0,0,1430238,0
OH,02336300,Knox County Career Center,Ohio,168704,457494,801000,1427198,0
MO,00470300,Logan University,Missouri,224284,425016,772000,1421300,0
CT,00140100,Post University,Connecticut,1419702,0,0,1419702,0
UT,01116500,Uintah Basin Technical College,Utah,167365,441354,810000,1418719,0
CA,04259700,University Of Saint Katherine,California,246937,426935,742000,1415872,0
WI,00663900,Bellin College,Wisconsin,219481,429279,766000,1414760,0
IL,00998700,Saint Anthony College Of Nursing,Illinois,245511,422976,740000,1408487,0
CA,01170700,North-West College,California,1406776,0,0,1406776,0
OK,01034200,Southern Oklahoma Area Vocational Technical District #20,Oklahoma,252054,409934,743000,1404988,0
AR,00109500,Crowley'S Ridge College,Arkansas,265023,415315,722000,1402338,0
CA,03797400,Career Care Institute,California,1401625,0,0,1401625,0
TX,00356100,Cedar Valley College,Texas,1401492,0,0,1401492,0
CA,03889300,Stanbridge University,California,1395629,0,0,1395629,0
TN,00530700,Tennessee College Of Applied Technology--Mcminnville,Tennessee,230898,421547,737000,1389445,0
FL,02554200,Radford M. Locklin Technical College,Florida,177103,438306,774000,1389409,0
LA,02166200,Iti Technical College,Louisiana,1381165,0,0,1381165,0
TX,04179500,North American University,Texas,244712,410312,726000,1381024,0
OK,04224900,College Of The Muscogee Nation,Oklahoma,239337,414665,723000,1377002,0
OH,02560700,Pickaway Ross County Joint Vocational School District,Ohio,243181,411338,722000,1376519,0
OH,02220800,Career & Technology Education Centers Of Licking County,Ohio,198541,425891,750000,1374432,0
OH,02304700,Tri-Rivers Career Center,Ohio,247988,411141,715000,1374129,0
OH,03068200,Ohio Media School,Ohio,1374115,0,0,1374115,0
OR,02330100,Pioneer Pacific College,Oregon,1373074,0,0,1373074,0
TX,01248300,Paul Mitchell The School Dallas,Texas,1367452,0,0,1367452,0
NY,00646700,Saint Joseph'S College Of Nursing At St Joseph'S Hospital Health Cente,New York,261644,402069,703000,1366713,0
OH,02337700,Professional Skills Institute,Ohio,1362751,0,0,1362751,0
NY,02172800,Dutchess Boces School Of Practical Nursing,New York,229402,381112,748000,1358514,0
OH,02352800,Polaris Career Center - Adult Education Department,Ohio,231446,409778,713000,1354224,0
NJ,04271200,Seminary Bnos Chaim,New Jersey,255559,399256,693000,1347815,0
OH,02351500,Northern Career Institute,Ohio,176450,428465,742000,1346915,0
OH,00812900,Adult And Community Education @Hudson,Ohio,284038,388440,674000,1346478,0
NC,00798800,Martin Community College,North Carolina,217290,408657,719000,1344947,0
MO,02266400,Central Christian College Of The Bible,Missouri,242288,401542,698000,1341830,0
NC,01179900,Paul Mitchell The School Fayetteville,North Carolina,1340711,0,0,1340711,0
FL,02089600,Concorde Career Institute,Florida,1340456,0,0,1340456,0
NY,00278300,New York Law School,New York,271478,374306,692000,1337784,0
CA,00448400,John F. Kennedy University,California,196815,404291,736000,1337106,0
TN,01155300,William R Moore College Of Technology,Tennessee,180060,418831,735000,1333891,0
AR,02272400,Eastern College Of Health Vocations,Arkansas,1332068,0,0,1332068,0
MN,03096400,Leech Lake Tribal College,Minnesota,219804,404474,702000,1326278,0
OK,00767800,Spartan College Of Aeronautics And Technology,Oklahoma,1326190,0,0,1326190,0
MO,00553200,Cape Girardeau Career And Technology Center,Missouri,206430,407135,711000,1324565,0
MO,00245000,Calvary University,Missouri,216452,402803,705000,1324255,0
MI,02588200,Douglas J Aveda Institute,Michigan,1324125,0,0,1324125,0
IL,00173200,National University Of Health Sciences (The),Illinois,290635,364355,666000,1320990,0
NY,00520800,College Of Westchester (The),New York,1320712,0,0,1320712,0
NY,02157900,Rochester General-Isabella Graham Hart School Of Practical Nursing,New York,229264,397898,690000,1317162,0
WV,00754400,Appalachian Bible College,West Virginia,238981,391112,684000,1314093,0
NC,02280900,Mid-Atlantic Christian University,North Carolina,242130,390579,681000,1313709,0
OH,02073300,Gallia Jackson Vinton Joint School Adult Education,Ohio,226505,397080,690000,1313585,0
NY,02235600,Erie 2 - Chautauqua - Cattaraugus Boces,New York,165833,239792,902000,1307625,0
CA,04208400,Riverside County Office Of Education,California,186455,400908,718000,1305363,0
CA,03084700,Ventura Adult And Continuing Education,California,207297,399893,697000,1304190,0
NY,03115300,Genesee-Livingston-Steuben-Wyoming Boces,New York,262134,377237,662000,1301371,0
CA,00394700,"University Of California, Hastings College Of The Law",California,276618,359671,665000,1301289,0
TX,02357700,Paul Mitchell The School Houston,Texas,1300078,0,0,1300078,0
NY,00746600,Lim College,New York,1293881,0,0,1293881,0
NY,00644500,Bill And Sandra Pomeroy College Of Nursing At Crouse Hospital,New York,207843,391341,682000,1281184,0
TX,03019800,Pci Health Training Center,Texas,1276232,0,0,1276232,0
TX,00497700,South Texas College Of Law Houston,Texas,263331,353441,653000,1269772,0
OH,02454400,Northeast Ohio Medical University,Ohio,272933,349668,646000,1268601,0
OK,01153700,Mid-America Area Vocational-Technical School District No. #8,Oklahoma,253644,359584,653000,1266228,0
UT,04191500,Tooele Technical College,Utah,115803,378812,770000,1264615,0
NY,00646100,Saint Elizabeth Medical Center,New York,220241,379861,660000,1260102,0
UT,04054300,Southwest Technical College,Utah,137095,400716,721000,1258811,0
VT,02532600,Landmark College,Vermont,210858,378549,669000,1258407,0
TX,02527500,Houston Training Schools,Texas,1254446,0,0,1254446,0
TX,01301600,Ogle School Hair Skin Nails,Texas,1248354,0,0,1248354,0
FL,03028200,Trinity College Of Florida,Florida,194883,383451,666000,1244334,0
VA,02320900,Tidewater Tech,Virginia,1243306,0,0,1243306,0
NY,00397800,Rabbinical Seminary Of America,New York,258526,350073,634000,1242599,0
MA,00632200,Signature Healthcare Brockton Hospital School Of Nursing,Massachusetts,216076,374477,652000,1242553,0
PR,03452300,Colegio Educativo Tecnológico Industrial,Puerto Rico,276174,354111,612000,1242285,0
CA,00697500,Lincoln University,California,310107,331212,600000,1241319,0
CA,00127800,San Francisco Conservatory Of Music,California,249016,348163,642000,1239179,43146000
NY,02160100,Geneva General Hospital,New York,237274,361172,633000,1231446,0
NC,00295600,Piedmont International University,North Carolina,407862,823035,0,1230897,0
KS,02090700,Cleveland University-Kansas City,Kansas,223811,363417,642000,1229228,0
OK,01076200,Western Technology Center School District No. 12,Oklahoma,240715,357148,631000,1228863,0
FL,03071600,College Of Business & Technology,Florida,1227280,0,0,1227280,0
KS,00191700,Barclay College,Kansas,214618,368996,643000,1226614,0
CA,02096100,Fielding Graduate University,California,231198,349312,646000,1226510,0
CA,03266300,Bethesda University,California,222826,361033,633000,1216859,0
FL,03856300,Universal Career School,Florida,1214724,0,0,1214724,0
TX,03542300,Concorde Career College,Texas,1209817,0,0,1209817,0
NY,04265900,Yeshiva Kollel Tifereth Elizer,New York,241572,353452,611000,1206024,0
VA,03106500,Sentara College Of Health Sciences,Virginia,178560,371502,652000,1202062,0
CA,04057300,Asher College,California,1201948,0,0,1201948,0
OK,03198400,Mid-Del Technology Center,Oklahoma,135205,380123,678000,1193328,0
LA,02538300,Delta College Of Arts & Technology,Louisiana,1192751,0,0,1192751,0
FL,03434300,Fortis College,Florida,1192474,0,0,1192474,0
MD,00208700,Ner Israel Rabbinical College,Maryland,229867,342629,611000,1183496,0
FL,03100800,Big Bend Technical College,Florida,198157,357947,625000,1181104,0
PA,00536500,York County School Of Technology,Pennsylvania,205192,350014,620000,1175206,0
CO,03066900,Intellitec College,Colorado,1174578,0,0,1174578,0
NY,02206000,Hunter Business School,New York,1168966,0,0,1168966,0
NJ,04265300,Yeshiva Gedolah Keren Hatorah,New Jersey,229239,342779,596000,1168018,0
NY,01240700,Schuyler Steuben Chemung Tioga Allegany Boces,New York,108927,246401,804000,1159328,0
TX,01076100,Dallas Institute Of Funeral Service,Texas,220704,341830,596000,1158534,0
IL,00621400,Blessing Hospital,Illinois,210868,342254,602000,1155122,0
OH,01032300,Hannah E Mullins School Of Practical Nursing,Ohio,164959,361994,627000,1153953,0
AZ,02113600,American Intercontinental University,Arizona,1150405,0,0,1150405,0
MD,00793600,Lincoln College Of Technology,Maryland,1149547,0,0,1149547,0
TX,03727600,Auguste Escoffier School Of Culinary Arts,Texas,1148379,0,0,1148379,0
NY,04210400,Beth Medrash Meor Yitzchok,New York,228892,334848,584000,1147740,0
PA,00657400,"St. Luke'S Hospital Of Bethlehem, Pa",Pennsylvania,191622,346459,608000,1146081,0
CA,03999300,Beaumont Adult School,California,156954,334960,654000,1145914,0
MA,02163600,William James College,Massachusetts,232998,320587,590000,1143585,0
CA,01291200,Mti College,California,1142459,0,0,1142459,0
OH,03034200,Washington County Career Center Adult Education,Ohio,146812,354896,640000,1141708,0
OK,01120600,Pioneer Technology Center,Oklahoma,262829,316361,561000,1140190,0
MO,00542900,Rolla Technical Institute Center,Missouri,210305,307498,620000,1137803,0
OR,02101000,Northwest College School Of Beauty,Oregon,1136700,0,0,1136700,0
ND,01205900,Trinity Bible College And Graduate School,North Dakota,204391,339024,593000,1136415,0
AK,04138600,Alaska Christian College,Alaska,201678,342002,592000,1135680,0
WV,01124500,West Virginia School Of Osteopathic Medicine,West Virginia,247036,311772,576000,1134808,0
CA,03144400,American College Of Healthcare And Technology,California,1134326,0,0,1134326,0
CO,02253700,Intellitec College,Colorado,1132045,0,0,1132045,0
FL,04083400,Cambridge College Of Healthcare & Technology,Florida,1131811,0,0,1131811,0
KY,03611300,Brighton Center'S Center For Employment Training,Kentucky,92638,368508,666000,1127146,0
PA,02107300,Pennsylvania Academy Of The Fine Arts,Pennsylvania,222164,327432,577000,1126596,0
KS,00193100,Manhattan Christian College,Kansas,204954,333837,583000,1121791,0
NY,02582000,Bnos Zion Of Bobov Seminary,New York,215691,331316,574000,1121007,0
CA,02596400,Spartan College Of Aeronautics & Technology,California,1117522,0,0,1117522,0
MI,03124000,Northwestern Technological Institute,Michigan,1108949,0,0,1108949,0
NY,00752200,Continental School Of Beauty Culture,New York,1106191,0,0,1106191,0
WV,01290500,Academy Of Careers And Technology,West Virginia,174170,328076,601000,1103246,0
WV,02534800,Fred W. Eberle Technical Center,West Virginia,121970,257779,723000,1102749,0
NY,01236400,St. Paul'S School Of Nursing,New York,1102325,0,0,1102325,0
NY,00288700,Albany Medical College,New York,234607,304631,563000,1102238,0
ID,02218000,Carrington College,Idaho,1101321,0,0,1101321,0
CA,00616500,Los Angeles County College Of Nursing And Allied Health,California,174062,336733,588000,1098795,0
OH,00915600,Wayne County Schools Career Center,Ohio,120311,302849,675000,1098160,0
NJ,00641700,Holy Name Medical Center School Of Nursing,New Jersey,206390,289450,593000,1088840,0
PR,03070500,D'Mart Institute,Puerto Rico,1086083,0,0,1086083,0
OR,02534000,National University Of Natural Medicine,Oregon,217745,305236,556000,1078981,0
TN,03982300,Visible Music College,Tennessee,185814,324819,566000,1076633,0
FL,04150800,Immokalee Technical College,Florida,181354,323216,570000,1074570,0
TN,03008800,Brillare Beauty Institute,Tennessee,191387,305891,577000,1074278,0
PA,00778000,New Castle School Of Trades,Pennsylvania,1073423,0,0,1073423,0
OH,01224800,Central School Of Practical Nursing,Ohio,218545,311893,541000,1071438,0
MT,00252900,Dawson Community College,Montana,142151,332253,588000,1062404,0
OR,03042500,Carrington College,Oregon,1060396,0,0,1060396,0
MN,00239100,Mitchell Hamline School Of Law,Minnesota,212893,296989,549000,1058882,0
NY,00947900,St. Paul'S School Of Nursing,New York,1056892,0,0,1056892,0
MT,02343000,Fort Peck Community College,Montana,151493,324875,579000,1055368,0
TN,00350600,Meharry Medical College,Tennessee,219976,292851,541000,1053827,159146000
CA,04153900,Providence Christian College,California,195829,312235,544000,1052064,0
PA,02151500,Central Susquehanna Lpn Career Center,Pennsylvania,211480,306140,532000,1049620,0
PR,02195900,Modern Hairstyling Institute,Puerto Rico,1048362,0,0,1048362,0
AL,03361400,Fortis College,Alabama,1046187,0,0,1046187,0
PR,03104400,Advantage Technical College,Puerto Rico,1045941,0,0,1045941,0
TX,00361800,Southwestern Christian College,Texas,143039,328569,569000,1040608,0
OH,02220500,God'S Bible School & College,Ohio,154996,321577,562000,1038573,0
MN,00677500,Rainy River Community College,Minnesota,161267,317295,559000,1037562,0
PR,02195400,Modern Hairstyling Institute,Puerto Rico,1036256,0,0,1036256,0
SD,02277300,Sisseton Wahpeton College,South Dakota,157620,319636,558000,1035256,0
OH,00747300,Choffin Career & Technical Center,Ohio,186502,307569,539000,1033071,0
IL,01236200,Northwestern College,Illinois,1029287,0,0,1029287,0
MO,02340500,Saint Louis College Of Health Careers,Missouri,1026542,0,0,1026542,0
IL,00177800,Vandercook College Of Music,Illinois,158225,308298,560000,1026523,0
CA,03874400,Community Christian College,California,113974,332179,577000,1023153,0
NJ,02092300,Eastwick College - Nutley Campus,New Jersey,1022459,0,0,1022459,0
TX,03573300,Aviation Institute Of Maintenance,Texas,1018117,0,0,1018117,0
PR,03157600,"Colegio De Cinematografía, Artes Y Televisión",Puerto Rico,1018034,0,0,1018034,0
ME,00630500,Maine College Of Health Professions,Maine,162446,309324,546000,1017770,0
OH,03468500,Mdt College Of Health Sciences,Ohio,1017059,0,0,1017059,0
NJ,03122600,Eastern International College,New Jersey,1016203,0,0,1016203,0
KY,04229300,Medquest College,Kentucky,1013074,0,0,1013074,0
TX,02230600,Ogle School Hair Skin Nails,Texas,1012829,0,0,1012829,0
LA,03332600,Delta College,Louisiana,1012095,0,0,1012095,0
MI,03915300,Career Quest Learning Centers,Michigan,1005286,0,0,1005286,0
NY,01227700,New York Chiropractic College,New York,220590,275168,509000,1004758,58663000
MD,02545400,North American Trade Schools,Maryland,1004497,0,0,1004497,0
NY,04227200,Bet Medrash Gadol Ateret Torah,New York,196283,293864,511000,1001147,0
TX,00694100,Dallas Christian College,Texas,164340,302140,530000,996480,0
IN,00457900,International Business College,Indiana,995201,0,0,995201,0
AZ,04152900,Studio Academy Of Beauty (The),Arizona,994090,0,0,994090,0
OH,02620000,Sandusky Career Center,Ohio,174031,292424,527000,993455,0
PA,00533000,Fayette County Career & Technical Institute,Pennsylvania,195264,292091,506000,993355,0
CA,03171300,University Of St. Augustine For Health Sciences,California,993092,0,0,993092,0
PR,02234900,Antilles College Of Health,Puerto Rico,985427,0,0,985427,0
MO,00542400,South Central Career Center,Missouri,176341,286468,522000,984809,0
PA,01081400,Pittsburgh Institute Of Mortuary Science,Pennsylvania,170652,293693,519000,983345,0
PA,00653400,Citizens School Of Nursing,Pennsylvania,174244,292971,516000,983215,0
CA,00853700,Concorde Career College,California,982367,0,0,982367,0
CA,00129500,Southwestern Law School,California,212120,269763,499000,980883,0
NJ,02131600,Pennco Tech,New Jersey,979653,0,0,979653,0
IL,02522800,Fox College,Illinois,979641,0,0,979641,0
MI,00226900,Great Lakes Christian College,Michigan,159906,298456,518000,976362,0
PR,04117200,Instituto Educativo Premier,Puerto Rico,974349,0,0,974349,0
IL,04242800,Coalition Of African American Nurses,Illinois,125975,244318,604000,974293,0
NV,02621500,Career College Of Northern Nevada,Nevada,974259,0,0,974259,0
CA,02231900,Gemological Institute Of America,California,176142,251997,543000,971139,0
WA,03724300,Digipen Institute Of Technology,Washington,961951,0,0,961951,0
PR,04250900,Inter American University Of Puerto Rico - School Of Law,Puerto Rico,193606,269630,498000,961236,0
WV,02218200,Garnet Career Center,West Virginia,148515,296103,514000,958618,0
OH,03015100,Alliance Career Center,Ohio,108179,269624,579000,956803,0
PA,00489900,Upmc Mercy School Of Nursing,Pennsylvania,175624,284016,496000,955640,0
IL,03101800,Illinois Media School,Illinois,954313,0,0,954313,0
CA,04142500,Touro University Worldwide,California,87768,313122,551000,951890,0
SC,02341100,Kenneth Shuler School Of Cosmetology & Nails,South Carolina,951470,0,0,951470,0
OH,02158500,Ohio Business College,Ohio,948103,0,0,948103,0
PR,03336300,Century College,Puerto Rico,947701,0,0,947701,0
CO,02594300,Collegeamerica Denver,Colorado,944384,0,0,944384,0
AK,02541000,Alaska Career College,Alaska,941040,0,0,941040,0
TX,04121800,Criswell College,Texas,152588,286200,501000,939788,0
NY,01198400,Ohr Hameir Theological Seminary,New York,184006,275552,479000,938558,0
WA,02222900,International Air & Hospitality Academy,Washington,936798,0,0,936798,0
PA,03781300,Pitc Institute,Pennsylvania,936629,0,0,936629,0
PR,03122500,Academia Serrant,Puerto Rico,936113,0,0,936113,0
MA,01238600,Southeastern Regional Vocational Technical School,Massachusetts,156398,277315,502000,935713,0
IL,00888000,Morrison Institute Of Technology,Illinois,180060,275067,480000,935127,0
AR,03855300,Ecclesia College,Arkansas,148173,273519,508000,929692,0
NC,04120300,Health And Style Institute,North Carolina,927846,0,0,927846,0
MO,02124500,Franklin Technology Center,Missouri,202194,261263,464000,927457,0
MT,02517500,Aaniiih Nakoda College,Montana,114359,295974,517000,927333,0
CA,01310300,California Western School Of Law,California,196710,256504,474000,927214,0
AZ,03034400,Conservatory Of Recording Arts & Sciences,Arizona,926993,0,0,926993,0
PA,00752900,Chester County Intermediate Unit Practical Nursing Program,Pennsylvania,158967,280350,487000,926317,0
OK,00996300,Caddo-Kiowa Area Vocational-Technical School District No. 2,Oklahoma,169573,272152,484000,925725,0
WA,03689400,Faith International University,Washington,162349,274839,488000,925188,0
MN,04271800,Red Lake Nation College,Minnesota,151473,282627,491000,925100,0
PA,03098600,Career Technology Center Of Lackawanna County,Pennsylvania,174002,274681,476000,924683,0
MI,04163300,Compass College Of Cinematic Arts,Michigan,186951,267935,468000,922886,0
WI,02532200,Lac Courte Oreilles Ojibwe College,Wisconsin,31226,125237,765000,921463,0
CA,02343400,Bellus Academy,California,915623,0,0,915623,0
CO,02156200,Technical College Of The Rockies,Colorado,128974,280929,505000,914903,0
CA,02497300,Milan Institute,California,914326,0,0,914326,0
MA,03946300,Franklin W. Olin College Of Engineering,Massachusetts,178424,263423,471000,912847,0
NY,03147300,Yeshiva D'Monsey,New York,182423,266255,463000,911678,0
NY,04230100,Rabbinical College Ohr Yisroel,New York,176604,267738,465000,909342,0
CA,02553600,Diversified Vocational College,California,908774,0,0,908774,0
FL,03008600,Cortiva Institute,Florida,908597,0,0,908597,0
PA,02492600,Eastern Center For Arts And Technology-Practical Nursing,Pennsylvania,157939,263505,486000,907444,0
NY,04259000,Yeshiva Shaar Ephraim,New York,175684,266626,463000,905310,0
WV,00382000,Salem University,West Virginia,904789,0,0,904789,0
OH,02245600,Warren County Career Center,Ohio,107854,256031,539000,902885,0
WA,03917300,Evergreen Beauty And Barber College,Washington,902623,0,0,902623,0
CA,04181200,Southern California Health Institute (Sochi),California,902290,0,0,902290,0
NJ,02053700,Eastwick College,New Jersey,895753,0,0,895753,0
NY,00479800,Mirrer Yeshiva Central Institute,New York,156376,268703,469000,894079,0
NY,04245600,Yeshivas Maharit D'Satmar,New York,174514,263183,456000,893697,0
NJ,04273800,Yeshiva Gedola Tiferes Yerachmiel,New Jersey,179422,260236,453000,892658,0
NE,03323300,Little Priest Tribal College,Nebraska,144184,272758,475000,891942,0
OK,00531200,Red River Technology Center School District 19,Oklahoma,156175,263657,471000,890832,0
CA,00793000,Concorde Career College,California,887365,0,0,887365,0
HI,04252700,Pacific Rim Christian University,Hawaii,156569,266359,464000,886928,0
MO,03579300,Texas County Technical Institute,Missouri,155166,263542,468000,886708,0
OH,00303100,Cleveland Institute Of Music (The),Ohio,186268,250323,450000,886591,0
AR,03124900,Imagine - Paul Mitchell Partner School,Arkansas,883707,0,0,883707,0
KY,02491100,Beckfield College,Kentucky,881109,0,0,881109,0
NY,01037800,Rabbinical College Of Long Island,New York,170473,258635,452000,881108,0
OR,01230900,University Of Western States,Oregon,164488,251335,465000,880823,0
AL,04226700,Alabama College Of Osteopathic Medicine,Alabama,186805,242819,449000,878624,0
CA,03853300,Keck Graduate Institute Of Applied Life Sciences,California,189117,241924,447000,878041,0
OH,04117300,Dayton School Of Medical Massage,Ohio,875986,0,0,875986,0
CA,03973300,Sae Expression College,California,875264,0,0,875264,0
CA,00123000,Marshall B. Ketchum University,California,145778,255280,472000,873058,23988000
OH,02522700,Eastland-Fairfield Career And Technical Schools,Ohio,133125,230759,509000,872884,0
OH,04244300,Antioch College,Ohio,164109,258673,449000,871782,0
NY,01081300,American Academy Mcallister Institute,New York,93366,283171,495000,871537,0
CA,03696300,University Of The West,California,140086,263934,467000,871020,0
TX,02081400,Arlington Baptist University,Texas,151631,262372,457000,871003,0
MO,03070900,Southeast Missouri Hospital College Of Nursing And Health Sciences,Missouri,131509,266731,470000,868240,0
PR,03177300,San Juan Bautista School Of Medicine,Puerto Rico,173235,249830,445000,868065,0
KS,02168900,Kansas Christian College,Kansas,117258,273937,476000,867195,0
IN,00625700,Saint Elizabeth School Of Nursing,Indiana,136328,266111,464000,866439,0
WV,02275300,Cabell County Career Technology Center,West Virginia,160620,257572,447000,865192,0
PA,03128400,Delaware County Technical School,Pennsylvania,150255,261376,453000,864631,0
TX,02568100,Texas Barber College,Texas,863797,0,0,863797,0
CA,02228500,Life Chiropractic College West,California,171227,242238,448000,861465,0
CA,00760700,Concorde Career College,California,861408,0,0,861408,0
NY,01256100,Five Towns College,New York,860147,0,0,860147,0
OH,02140700,Canton City School District Adult Career & Technical Education,Ohio,181545,247976,430000,859521,0
CA,00807100,Concorde Career College,California,857787,0,0,857787,0
NY,02169100,Davis College,New York,135671,262894,459000,857565,0
FL,03264300,South Florida Bible College And Theological Seminary,Florida,96848,281055,478000,855903,0
CA,02161800,Musicians Institute,California,854505,0,0,854505,0
WV,00835500,James Rumsey Technical Institute,West Virginia,138292,261029,455000,854321,0
MI,00231100,Kuyper College,Michigan,166221,249551,436000,851772,0
NV,04171000,Advanced Training Institute,Nevada,850047,0,0,850047,0
VA,01004300,Bon Secours Memorial College Of Nursing,Virginia,141069,254185,452000,847254,0
GA,03005400,Georgia Career Institute,Georgia,846937,0,0,846937,0
OH,02187900,Ashtabula County Technical And Career Campus,Ohio,124546,222067,499000,845613,0
NJ,01246200,Eastwick College - Hackensack Campus.,New Jersey,844520,0,0,844520,0
IA,00729100,St. Luke'S College,Iowa,136761,256703,449000,842464,0
MN,03921400,White Earth Tribal And Community College,Minnesota,105200,269057,467000,841257,0
NY,00397600,Rabbinical Academy Mesivta Rabbi Chaim Berlin,New York,168667,240703,428000,837370,0
TN,01046000,American Baptist Theological Seminary,Tennessee,152145,250134,434000,836279,0
OK,03008700,Southwest Technology Center School District # 27,Oklahoma,113543,261363,460000,834906,0
DC,03750300,Prospect College,District of Columbia,830854,0,0,830854,0
PR,03085700,Professional Technical Institution,Puerto Rico,827459,0,0,827459,0
DE,04139800,Delaware College Of Art And Design,Delaware,168154,239395,417000,824549,0
FL,03382300,North Florida Technical College,Florida,134851,249666,438000,822517,0
CA,04227000,Abc Adult School,California,133978,210313,478000,822291,0
IL,00622500,Trinity College Of Nursing & Health Sciences,Illinois,127554,251781,441000,820335,0
OH,03534400,American Institute Of Alternative Medicine,Ohio,818622,0,0,818622,0
TX,02259400,Amberton University,Texas,135514,241006,441000,817520,0
NY,02069000,New York School Of Interior Design,New York,117250,250094,450000,817344,0
OK,03126200,Green Country Technology Center,Oklahoma,157598,237307,421000,815905,0
PR,03075600,Emma'S Beauty Academy,Puerto Rico,814149,0,0,814149,0
IL,00168900,Illinois College Of Optometry,Illinois,174875,223171,413000,811046,0
MD,03296300,Cortiva Institute,Maryland,809235,0,0,809235,0
PA,02350100,Western Area Career & Technology Center,Pennsylvania,123771,191591,493000,808362,0
MT,02545200,Chief Dull Knife College,Montana,103368,254495,450000,807863,0
NY,00643800,Phillips School Of Nursing At Mount Sinai Beth Israel,New York,151193,236544,419000,806737,0
OH,02336700,Cuyahoga Valley Career Center,Ohio,164195,234082,407000,805277,0
FL,03089200,Nouvelle Institute,Florida,805020,0,0,805020,0
CA,02597300,South Baylo University,California,213732,227872,361000,802604,0
OH,03583300,Ohio Institute Of Allied Health,Ohio,101503,254527,446000,802030,0
OR,03642300,Institute Of Technology,Oregon,799110,0,0,799110,0
FL,04134800,Aveda Institute - Tallahassee,Florida,798287,0,0,798287,0
PA,01326300,South Hills School Of Business & Technology,Pennsylvania,795265,0,0,795265,0
MA,00396500,Bay State College,Massachusetts,794883,0,0,794883,0
PA,03011600,Fortis Institute,Pennsylvania,791394,0,0,791394,0
AR,02330800,Jrmc School Of Nursing,Arkansas,142391,233208,415000,790599,0
CO,00135200,Denver Seminary,Colorado,137773,228720,423000,789493,0
NC,04154200,Carolina College Of Biblical Studies,North Carolina,119702,243633,424000,787335,0
CA,02577900,Santa Barbara Business College,California,786894,0,0,786894,0
NY,03191300,Cuny School Of Law '(The)',New York,141995,225396,417000,784391,0
NJ,03650600,Pc Age,New Jersey,782767,0,0,782767,0
FL,04156400,Aviation Institute Of Maintenance,Florida,782346,0,0,782346,0
PA,04149800,Somerset County Technology Center,Pennsylvania,139358,234539,407000,780897,0
FL,03842500,Cambridge Institute Of Allied Health And Technology,Florida,779045,0,0,779045,0
NY,04231500,Yeshiva Sholom Shachna,New York,153086,228120,397000,778206,0
TX,03733300,Baptist University Of The Americas,Texas,122224,238328,416000,776552,0
OH,04149100,Paul Mitchell The School Cincinnati,Ohio,776215,0,0,776215,0
IL,01050100,Lakeview College Of Nursing,Illinois,140717,230720,404000,775437,0
FL,04128400,Miami Regional University,Florida,774452,0,0,774452,0
FL,02149900,Paul Mitchell The School-Jacksonville,Florida,773577,0,0,773577,0
OK,01128200,Oklahoma State University Center For Health Sciences,Oklahoma,144134,220100,407000,771234,0
WA,04223600,Academy Of Interactive Entertainment,Washington,140430,229333,401000,770763,0
UT,01009800,Neumont College Of Computer Science,Utah,769673,0,0,769673,0
WA,04130500,Pacific Northwest University Of Health Sciences,Washington,166437,211659,391000,769096,0
PR,03781400,Industrial Technical College,Puerto Rico,768357,0,0,768357,0
PR,03025900,"Liceo De Arte, Diseños Y Comercio",Puerto Rico,767805,0,0,767805,0
PA,00658300,Western Pennsylvania Hospital School Of Nursing,Pennsylvania,141885,223212,401000,766097,0
OK,02597400,Pontotoc Technology Center District #14,Oklahoma,145011,212946,407000,764957,0
VT,01193400,Vermont Law School,Vermont,151393,215512,398000,764905,0
AK,03160300,Alaska Vocational Technical Center,Alaska,71437,252317,441000,764754,0
VT,02143500,Sterling College,Vermont,129712,228347,404000,762059,0
CO,00764900,Rocky Mountain College Of Art + Design,Colorado,761314,0,0,761314,0
TX,02285900,Ucas University Of Cosmetology Arts & Sciences,Texas,760609,0,0,760609,0
AZ,02559000,University Of Advancing Computer Technology,Arizona,759682,0,0,759682,0
NY,04251400,Elim Bible Institute And College,New York,151944,221373,386000,759317,0
FL,03078000,Miami Media School,Florida,757634,0,0,757634,0
PA,04167200,Geisinger Commonwealth School Of Medicine,Pennsylvania,160035,209453,387000,756488,0
OH,03051400,Auburn Career Center,Ohio,124034,228775,402000,754809,0
CO,04148300,Denver College Of Nursing,Colorado,753229,0,0,753229,0
OH,00485300,Bradford School,Ohio,752083,0,0,752083,0
CA,04152800,Paul Mitchell The School Sacramento,California,750351,0,0,750351,0
CA,03125800,Premiere Career College,California,747470,0,0,747470,0
MA,00216400,New England College Of Optometry (The),Massachusetts,163236,204223,378000,745459,0
ID,02607100,Paul Mitchell The School Boise,Idaho,740779,0,0,740779,0
LA,02554800,Vanguard College Of Cosmetology A Paul Mitchell Partner School-Metaire,Louisiana,736592,0,0,736592,0
OK,02250900,Eastern Oklahoma County Technology Center School District #23,Oklahoma,114478,218825,397000,730303,0
CA,00884600,Wright Institute (The),California,145487,204327,378000,727814,0
PA,02092500,Laurel Technical Institute,Pennsylvania,727647,0,0,727647,0
PA,02306200,Venango County Area Vocational Technical School,Pennsylvania,134117,197655,395000,726772,0
NJ,04123400,Yeshivas Be'Er Yitzchok,New Jersey,139993,214403,372000,726396,0
CA,04167000,Paul Mitchell The School Temecula,California,725475,0,0,725475,0
NY,02546300,Yeshiva Of The Telshe Alumni,New York,139972,212344,371000,723316,0
TX,04193000,Rio Grande Valley College,Texas,722800,0,0,722800,0
CA,03403300,Epic Bible College,California,93800,227409,400000,721209,0
TN,00351700,Southern College Of Optometry,Tennessee,156253,197963,366000,720216,0
PA,02350200,Indiana County Technology Center,Pennsylvania,131498,214580,373000,719078,0
DC,00146400,Wesley Theological Seminary,District of Columbia,142919,201191,372000,716110,0
CA,03752400,Sum Bible College & Theological Seminary,California,26609,249266,437000,712875,0
SC,04222000,Arclabs,South Carolina,712771,0,0,712771,0
IN,04130900,Tricoci University Of Beauty Culture,Indiana,711717,0,0,711717,0
OH,02586400,Trumbull Career And Technical Center-Adult Training Center,Ohio,112359,190643,407000,710002,0
FL,02279600,Cortiva Institute,Florida,709623,0,0,709623,0
ID,02234500,Boise Bible College,Idaho,130055,211493,368000,709548,0
AL,03894300,Huntsville Bible College,Alabama,96521,223392,388000,707913,0
NY,01119200,Beth Hamedrash Shaarei Yosher Institute,New York,133173,209184,363000,705357,0
UT,02270800,Ameritech College,Utah,705243,0,0,705243,0
WV,02535500,Mercer County Technical Education Center,West Virginia,105541,213047,385000,703588,0
MI,02237800,Specs Howard School Of Media Arts,Michigan,702843,0,0,702843,0
CA,00117700,Cogswell Polytechnical College,California,701472,0,0,701472,0
GA,02482100,Morehouse School Of Medicine,Georgia,147523,193537,358000,699060,0
FL,04182600,Hci College,Florida,698258,0,0,698258,0
MA,03115200,Motoring Technical Training Institute,Massachusetts,698220,0,0,698220,0
NY,02126300,Madison Oneida Boces Practical Nursing Program,New York,89648,178563,430000,698211,0
PA,03110700,Aviation Institute Of Maintenance,Pennsylvania,698192,0,0,698192,0
OH,03023700,Madison Adult Career Center,Ohio,110102,210003,373000,693105,0
OR,02159700,New Hope Christian College,Oregon,127250,206731,359000,692981,0
TN,00865500,Genesis Career College,Tennessee,692917,0,0,692917,0
OH,03319300,Creative Images Institute Of Cosmetology,Ohio,692021,0,0,692021,0
NY,02170000,Swedish Institute,New York,691142,0,0,691142,0
HI,04182200,Hawaii Medical College,Hawaii,690676,0,0,690676,0
MS,00243500,Southeastern Baptist College,Mississippi,73845,225049,390000,688894,0
MA,00891600,New England Law | Boston,Massachusetts,148978,188842,349000,686820,0
NY,00266900,Bank Street College Of Education,New York,124021,197364,365000,686385,49109000
MD,02333000,Hair Academy,Maryland,685979,0,0,685979,0
AR,04276100,Champion Christian College,Arkansas,87078,218514,379000,684592,0
PR,02570400,Educational Technical College (Edutec),Puerto Rico,682212,0,0,682212,0
TX,03723300,Culinary Institute Lenotre,Texas,682153,0,0,682153,0
NE,02550800,Nebraska Indian Community College,Nebraska,77576,219271,385000,681847,0
CA,01111700,Alliant International University,California,679282,0,0,679282,0
NY,03496300,Yeshiva Shaarei Torah Of Rockland,New York,136261,197398,345000,678659,0
IL,00171700,Macmurray College,Illinois,677656,0,0,677656,0
FL,04016500,American Institute Of Beauty,Florida,676204,0,0,676204,0
FL,04119400,Aveda Institute - South Florida,Florida,676153,0,0,676153,0
PA,02112200,Great Lakes Institute Of Technology,Pennsylvania,675003,0,0,675003,0
NJ,00759300,Parisian Beauty Academy Paul Mitchell Partner School,New Jersey,673639,0,0,673639,0
OH,01174500,Ohio Technical College,Ohio,671034,0,0,671034,0
MN,00999200,Oak Hills Christian College,Minnesota,111319,204257,355000,670576,0
WI,04159400,Columbia College Of Nursing,Wisconsin,121544,199456,348000,669000,0
PA,00944900,Pennco Tech,Pennsylvania,667974,0,0,667974,0
FL,03114700,Praxis Institute,Florida,663998,0,0,663998,0
OH,03065900,Buckeye Career Center,Ohio,118342,198159,344000,660501,0
GU,03438300,Pacific Islands University,Guam,120440,197531,342000,659971,0
NY,02098400,Herkimer County Boces Practical Nursing Program,New York,117344,197198,342000,656542,0
NY,02265100,Yeshiva Derech Chaim,New York,128724,191008,335000,654732,0
SC,02063700,Sherman College Of Straight Chiropractic,South Carolina,136466,181651,336000,654117,0
NY,00924800,Samaritan Hospital School Of Nursing,New York,110633,197013,343000,650646,0
UT,02556800,Paul Mitchell The School Salt Lake City,Utah,647756,0,0,647756,0
PR,02576100,Escuela Técnica De Electricidad,Puerto Rico,644003,0,0,644003,0
NY,04237200,Montefiore School Of Nursing,New York,94873,199194,349000,643067,0
MD,04188400,Bais Hamedrash And Mesivta Of Baltimore,Maryland,124132,187848,326000,637980,0
NY,04117700,"Monroe 2 - Orleans Boces, Center For Workforce Development",New York,92085,197197,344000,633282,0
OR,02104900,Sumner College,Oregon,632989,0,0,632989,0
NY,00288600,Albany Law School Of Union University,New York,117773,180629,334000,632402,0
TX,04146700,Aviation Institute Of Maintenance,Texas,631206,0,0,631206,0
MA,00466900,Upper Cape Cod Regional Technical School,Massachusetts,120421,180192,330000,630613,0
CA,02545900,Hypnosis Motivation Institute,California,56543,136342,437000,629885,0
WV,03098300,Putnam Career & Technical Center,West Virginia,106383,190673,332000,629056,0
OK,02600500,Wes Watkins Technology Center School District #25,Oklahoma,87161,185876,356000,629037,0
IL,03490300,Paul Mitchell The School Chicago,Illinois,626698,0,0,626698,0
TX,04168700,Peloton College,Texas,626237,0,0,626237,0
MA,00613600,National Aviation Academy - New England,Massachusetts,625133,0,0,625133,0
VT,00369700,Vermont College Of Fine Arts,Vermont,142286,169130,313000,624416,0
OR,00888700,Concorde Career College,Oregon,623986,0,0,623986,0
FL,04206300,Florida Vocational Institute,Florida,623164,0,0,623164,0
FL,02275100,Concorde Career Institute,Florida,621612,0,0,621612,0
SC,01209200,Kenneth Shuler School Of Cosmetology,South Carolina,620853,0,0,620853,0
NC,03570300,Carolina Christian College,North Carolina,114861,184859,321000,620720,0
OH,04235000,Felbry College-School Of Nursing,Ohio,617396,0,0,617396,0
PA,00791600,Franklin County Career And Technology Center,Pennsylvania,89503,190443,337000,616946,0
OH,01090600,Cincinnati College Of Mortuary Science,Ohio,134679,175892,306000,616571,0
OH,02116900,Upper Valley Career Center,Ohio,73618,197763,343000,614381,0
MO,00553100,Grand River Technical School,Missouri,113559,182186,317000,612745,0
SC,03052300,Kenneth Shuler School Of Cosmetology & Hair Design,South Carolina,611571,0,0,611571,0
NJ,01198900,Talmudical Academy,New Jersey,122458,178092,310000,610550,0
NJ,02104000,Harris School Of Business,New Jersey,609828,0,0,609828,0
VA,04127300,Columbia College,Virginia,609412,0,0,609412,0
NJ,00262600,Princeton Theological Seminary,New Jersey,143741,163528,302000,609269,1127362000
IL,00168500,Hebrew Theological College,Illinois,107582,181465,319000,608047,0
TN,02578200,Nossi College Of Art,Tennessee,606694,0,0,606694,0
NC,03555300,Southeastern Institute,North Carolina,605946,0,0,605946,0
PA,02158300,Mifflin County Academy Of Science And Technology,Pennsylvania,117767,177636,310000,605403,0
NY,03127100,Yeshivas Novominsk,New York,163597,160631,281000,605228,0
NY,04215900,Yeshiva Gedolah Kesser Torah,New York,115347,177692,310000,603039,0
CA,00902200,Associated Technical College,California,602768,0,0,602768,0
CO,04167100,Aveda Institute Denver,Colorado,602184,0,0,602184,0
FL,03224300,New Professions Technical Institute,Florida,600447,0,0,600447,0
GA,03089100,Georgia Institute Of Cosmetology,Georgia,599634,0,0,599634,0
OH,04137800,Aveda Institute Columbus,Ohio,599625,0,0,599625,0
CA,03650300,Tri-Community Adult Education,California,68720,170637,360000,599357,0
NY,03537300,New York Automotive & Diesel Institute,New York,598781,0,0,598781,0
AZ,04194500,Aveda Institute Tucson,Arizona,598691,0,0,598691,0
CA,04195400,Unitek College,California,598178,0,0,598178,0
OH,00888600,Portage Lakes Career Center,Ohio,106470,179039,312000,597509,0
NC,03777300,Paul Mitchell The School Gastonia,North Carolina,595930,0,0,595930,0
CT,00730500,Porter And Chester Institute Of Hamden,Connecticut,595156,0,0,595156,0
OK,02282100,"High Plains Technology Center, School District No. 24",Oklahoma,54421,194173,346000,594594,0
NY,04102300,New Age Training,New York,594376,0,0,594376,0
OR,00717800,Western Seminary,Oregon,100084,172607,319000,591691,0
CA,04141400,Laurus College,California,591076,0,0,591076,0
CA,04146000,National Career College,California,589577,0,0,589577,0
CO,03776300,Auguste Escoffier School Of Culinary Arts,Colorado,588381,0,0,588381,0
CT,02074000,Branford Hall Career Institute,Connecticut,588348,0,0,588348,0
PA,01252300,Talmudical Yeshiva Of Philadelphia,Pennsylvania,111069,156403,320000,587472,0
MA,02197900,North Bennet Street School,Massachusetts,119089,162637,304000,585726,0
CA,00274100,American Jewish University,California,111218,170995,302000,584213,0
NH,02140400,St. Joseph Hospital Of Nashua N.H.D/B/A St. Joseph School Of Nursing,New Hampshire,96027,176727,311000,583754,0
OH,00650700,Trinity Health System School Of Nursing,Ohio,99922,176816,307000,583738,0
GA,04203800,Woodruff Medical Training And Testing,Georgia,583499,0,0,583499,0
LA,02335700,Baton Rouge General Medical Center,Louisiana,69310,186886,326000,582196,0
IL,02150600,Cosmetology And Spa Academy,Illinois,582054,0,0,582054,0
NY,02153600,Broome Delaware Tioga Boces Program Of Practical Nursing,New York,94163,147601,340000,581764,0
CA,04003300,Blake Austin College,California,581595,0,0,581595,0
WV,03076500,Fayette Institute Of Technology,West Virginia,106163,160267,314000,580430,0
NY,00849500,Jamestown Business College,New York,577492,0,0,577492,0
FL,02188900,Hobe Sound Bible College,Florida,75745,173384,328000,577129,0
CA,03440400,Marian Health Careers Center,California,575634,0,0,575634,0
PA,00490200,Penn Commercial Business/Technical School,Pennsylvania,575574,0,0,575574,0
NY,01064100,Southern Westchester Boces,New York,92799,173278,307000,573077,0
NJ,04264900,Yeshiva Chemdas Hatorah,New Jersey,112892,167282,291000,571174,0
MI,03772300,Saginaw Chippewa Tribal College,Michigan,83912,176488,309000,569400,0
NY,02124000,Orange Ulster Boces School Of Practical Nursing,New York,97357,170810,301000,569167,0
PR,03124200,Nova College Of Puerto Rico,Puerto Rico,568986,0,0,568986,0
NC,03109000,School Of Communication Arts Of North Carolina,North Carolina,568133,0,0,568133,0
PA,00339300,Westminster Theological Seminary,Pennsylvania,96630,165242,306000,567872,0
NY,00644300,Cochran School Of Nursing Saint John'S Riverside Hosp,New York,86672,174690,304000,565362,0
CA,04115600,Mayfield College,California,564629,0,0,564629,0
PA,02251200,Schuylkill Technology Centers,Pennsylvania,106526,161766,294000,562292,0
CA,03027700,Pacific College Of Oriental Medicine,California,561804,0,0,561804,0
FL,02172700,Concorde Career Institute,Florida,561628,0,0,561628,0
PR,02189300,Emma'S Beauty Academy,Puerto Rico,561434,0,0,561434,0
NY,04125600,Career School Of Ny,New York,74214,178126,309000,561340,0
NY,01220300,St. Peter'S Hospital College Of Nursing,New York,84543,172938,302000,559481,0
NJ,04251500,Beth Medrash Of Asbury Park,New Jersey,109145,164258,286000,559403,0
TX,04178400,Vogue College Of Cosmetology,Texas,558728,0,0,558728,0
FL,03627600,Florida Education Institute,Florida,558247,0,0,558247,0
LA,03010400,Crescent City School Of Gaming & Bartending,Louisiana,557634,0,0,557634,0
PA,00856800,Vet Tech Institute,Pennsylvania,556560,0,0,556560,0
MO,04152200,Carthage R-9 School District/Carthage Technical Center,Missouri,96621,168356,291000,555977,0
FL,03570400,English Center (The),Florida,91968,162784,301000,555752,0
NJ,02586900,Harris School Of Business,New Jersey,554114,0,0,554114,0
CA,04162800,Paul Mitchell The School Modesto,California,553609,0,0,553609,0
CA,03043900,Newschool Of Architecture And Design,California,553090,0,0,553090,0
CA,02185800,Moler Barber College,California,551182,0,0,551182,0
NY,02199300,Orleans Niagara Boces,New York,113519,160272,277000,550791,0
PA,00489000,Central Penn College,Pennsylvania,550693,0,0,550693,0
CA,04165900,Paul Mitchell The School Fresno,California,550245,0,0,550245,0
NY,00992900,Suny College Of Optometry,New York,118717,151252,280000,549969,0
CA,03098700,Milan Institute,California,549033,0,0,549033,0
WA,01148100,Divers Institute Of Technology,Washington,548712,0,0,548712,0
CA,01186600,Lu Ross Academy,California,547287,0,0,547287,0
PR,03965400,Myrangel Beauty Institute,Puerto Rico,546026,0,0,546026,0
CA,02255400,Toni&Guy Hairdressing Academy,California,545266,0,0,545266,0
CA,01309500,Salon Success Academy,California,543888,0,0,543888,0
PA,03011500,Fortis Institute,Pennsylvania,542910,0,0,542910,0
NY,00274000,Jewish Theological Seminary Of America (The),New York,118674,147972,276000,542646,0
IL,00177900,Illinois Eastern Community Colleges - Wabash Valley College,Illinois,541848,0,0,541848,0
NJ,04081300,Bais Medrash Toras Chesed,New Jersey,68038,171733,302000,541771,0
FL,03816300,Artistic Nails & Beauty Academy,Florida,541307,0,0,541307,0
DE,03025800,Dawn Career Institute,Delaware,539645,0,0,539645,0
KY,02337200,Pj'S College Of Cosmetology,Kentucky,539531,0,0,539531,0
CO,00729700,Spartan College Of Aeronautics And Technology,Colorado,539465,0,0,539465,0
LA,03356300,Medical Training College,Louisiana,539363,0,0,539363,0
CA,00705000,Bellus Academy,California,539166,0,0,539166,0
CA,00725300,Federico Beauty Institute,California,538895,0,0,538895,0
TX,04129800,Mediatech Institute,Texas,538457,0,0,538457,0
IL,03098000,St. John'S College,Illinois,100955,156367,280000,537322,0
NY,02272900,Rockland County Boces Adult Education,New York,104744,158385,274000,537129,0
IL,04179100,Verve College,Illinois,537056,0,0,537056,0
NJ,02232500,Union County Vocational Technical Schools,New Jersey,100104,153054,280000,533158,0
TX,00660600,Baptist Health System School Of Health Professions,Texas,531618,0,0,531618,0
PA,02129000,Triangle Tech,Pennsylvania,530918,0,0,530918,0
AZ,03107000,Southwest College Of Naturopathic Medicine & Health Sciences,Arizona,114934,145960,270000,530894,0
VA,03126300,Aviation Institute Of Maintenance,Virginia,530011,0,0,530011,0
NH,02223300,Magdalen College,New Hampshire,103591,155397,271000,529988,0
MD,04151800,Temple (The): A Paul Mitchell Partner School,Maryland,528840,0,0,528840,0
WI,04193800,Shepherds College,Wisconsin,99604,155176,270000,524780,0
MO,04037500,Academy Of Hair Design,Missouri,524704,0,0,524704,0
PA,02203900,Erie Institute Of Technology,Pennsylvania,519694,0,0,519694,0
TX,03303300,Northwest Educational Center,Texas,519264,0,0,519264,0
NY,00274900,New York College Of Podiatric Medicine,New York,115225,141984,262000,519209,0
NH,03043100,Thomas More College Of Liberal Arts,New Hampshire,102524,151166,264000,517690,0
VA,04221000,"Standard Healthcare Services, College Of Nursing",Virginia,516309,0,0,516309,0
MI,00231300,Sacred Heart Major Seminary,Michigan,74193,156719,285000,515912,0
CA,04240200,Aviation Institute Of Maintenance,California,512166,0,0,512166,0
ND,02553700,Nueta Hidatsa Sahnish College,North Dakota,83694,157142,270000,510836,0
MI,02363800,Yeshiva Gedolah Of Greater Detroit,Michigan,100742,149742,260000,510484,0
WV,01274300,Benjamin Franklin Career & Technical Center,West Virginia,96740,132653,280000,509393,0
LA,04248400,Academy Of Interactive Entertainment,Louisiana,88545,153694,267000,509239,0
NY,00405400,Hebrew Union College - Jewish Institute Of Religion,New York,104168,141966,262000,508134,0
MA,00215400,Hellenic College & Holy Cross Greek Orthodox School Of Theology,Massachusetts,111043,143030,254000,508073,0
LA,00202700,Saint Joseph Seminary College,Louisiana,98377,145762,263000,507139,0
TX,03400300,Quest College,Texas,506799,0,0,506799,0
WV,00500700,West Virginia Junior College,West Virginia,506663,0,0,506663,0
GA,03812300,Omnitech Institute,Georgia,506117,0,0,506117,0
CA,03242300,Career Networks Institute,California,505137,0,0,505137,0
VA,04239500,Virginia University Of Integrative Medicine,Virginia,79436,149419,276000,504855,0
OK,02238500,Central Oklahoma College,Oklahoma,504384,0,0,504384,0
MO,03616300,Aviation Institute Of Maintenance,Missouri,503111,0,0,503111,0
ME,02104400,Spa Tech Institute,Maine,502984,0,0,502984,0
TX,02144800,Vet Tech Institute Of Houston,Texas,502030,0,0,502030,0
IL,04139000,Midwestern Career College,Illinois,501791,0,0,501791,0
KY,01048900,American National University,Kentucky,501696,0,0,501696,0
WV,01290400,Monongalia County Technical Education Center (Mtec),West Virginia,93681,148572,259000,501253,0
FL,03429600,Atlantic Institute Of Oriental Medicine,Florida,130647,129468,239000,499115,0
MO,00470700,Covenant Theological Seminary,Missouri,88666,144086,266000,498752,0
PA,02206200,Beauty Institute (The),Pennsylvania,497279,0,0,497279,0
IA,00189500,Waldorf University,Iowa,497220,0,0,497220,0
NJ,04154900,National Career Institute,New Jersey,497128,0,0,497128,0
IN,04121000,Mycomputercareer.Com /Techskills,Indiana,495594,0,0,495594,0
CA,04180000,Cinta Aveda Institute,California,493584,0,0,493584,0
NJ,02312000,Bergen County Technical Schools,New Jersey,76107,149957,266000,492064,0
NY,04234900,Amg School Of License Practical Nursing,New York,491430,0,0,491430,0
CA,00903200,Empire College,California,490975,0,0,490975,0
FL,03706300,Hollywood Institute,Florida,490367,0,0,490367,0
NJ,00545200,Teterboro School Of Aeronautics,New Jersey,490330,0,0,490330,0
FL,02326800,Meridian College,Florida,488558,0,0,488558,0
MA,00527900,Greater Lowell Regional Vocational Technical School,Massachusetts,94030,134707,259000,487737,0
MA,03235300,Massachusetts School Of Law At Andover,Massachusetts,110861,131604,243000,485465,0
NY,01005200,Jefferson Lewis Boces Program Of Practical Nursing,New York,105234,138888,241000,485122,0
PA,02174400,Triangle Tech,Pennsylvania,484941,0,0,484941,0
GA,04147000,Paul Mitchell The School Atlanta,Georgia,484422,0,0,484422,0
TX,03025000,Texas College Of Cosmetology,Texas,483500,0,0,483500,0
NJ,00849400,Hohokus School Of Trade And Technical Sciences,New Jersey,483327,0,0,483327,0
PA,02169600,Clearfield County Career And Technology Center,Pennsylvania,87950,136055,257000,481005,0
MO,01173500,Pike Lincoln Technical Center,Missouri,67332,107217,305000,479549,0
VA,03127500,Advanced Technology Institute,Virginia,479439,0,0,479439,0
NY,03713300,Beis Medrash Heichal Dovid,New York,96883,137156,242000,476039,0
MD,02578400,Maryland University Of Integrative Health,Maryland,91890,134889,249000,475779,0
CO,01285000,International Salon And Spa Academy,Colorado,475449,0,0,475449,0
MI,04164700,Keweenaw Bay Ojibwa Community College,Michigan,68566,148467,258000,475033,0
SC,03555400,Southeastern Institute,South Carolina,473641,0,0,473641,0
CA,03062400,Mount Diablo Adult Education,California,68958,140698,263000,472656,0
OH,03457300,Allegheny Wesleyan College,Ohio,83992,141323,246000,471315,0
MD,03965500,Hair Expressions Academy,Maryland,470791,0,0,470791,0
CO,01267000,Bel - Rea Institute Of Animal Technology,Colorado,470581,0,0,470581,0
WV,01057300,West Virginia Junior College,West Virginia,470415,0,0,470415,0
CA,02222000,American Film Institute Conservatory,California,98640,130412,241000,470052,0
NY,04261500,Mechon L'Hoyroa,New York,91885,138220,239000,469105,0
VA,02242400,Henrico County-Saint Mary'S Hospital School Of Practical Nursing,Virginia,110429,127210,231000,468639,0
NC,04173700,Grace College Of Divinity,North Carolina,71597,143192,251000,465789,0
TX,04187800,Cybertex Institute Of Technology,Texas,465548,0,0,465548,0
MO,00978200,Saint Luke'S College Of Health Sciences,Missouri,462823,0,0,462823,0
NV,04186300,Paul Mitchell The School Las Vegas,Nevada,462659,0,0,462659,0
OR,04171400,Aveda Institute Portland,Oregon,461109,0,0,461109,0
NV,04147600,Aveda Institute Las Vegas,Nevada,458983,0,0,458983,0
TX,00355600,Commonwealth Institute Of Funeral Service,Texas,64090,143732,251000,458822,0
CA,03736300,Advance Beauty College,California,458495,0,0,458495,0
GA,00411700,Grady Health System,Georgia,90793,133510,234000,458303,0
NY,01055100,New York School For Medical & Dental Assistants,New York,457757,0,0,457757,0
PA,03561400,Susquehanna County Career & Technology Center,Pennsylvania,53535,91598,312000,457133,0
IA,02160900,Pci Academy,Iowa,454747,0,0,454747,0
NC,00648300,Watts College Of Nursing,North Carolina,42191,55179,355000,452370,0
OH,04192200,Athena Career Academy,Ohio,451504,0,0,451504,0
FL,04194000,Treasure Coast Technical College,Florida,53915,142662,254000,450577,0
OK,02600000,"Northwest Technology Center, School District 10",Oklahoma,85786,130181,234000,449967,0
MA,00551900,Diman Regional Vocational Technical Institute,Massachusetts,81241,134391,234000,449632,0
IL,02073200,Telshe Yeshiva-Chicago,Illinois,86628,131342,230000,447970,0
WA,03065000,Paul Mitchell The School Richland,Washington,447875,0,0,447875,0
FL,04164600,D. A. Dorsey Technical College,Florida,51116,143641,253000,447757,0
CA,02602300,Central Coast College,California,447424,0,0,447424,0
CA,03868300,World Mission University,California,52382,142130,252000,446512,0
CA,04158200,Paul Mitchell The School Sherman Oaks,California,446039,0,0,446039,0
PA,02192800,Walnut Hill College,Pennsylvania,445337,0,0,445337,0
MN,02123200,Aveda Institute Minneapolis,Minnesota,445074,0,0,445074,0
NY,04262200,Elyon College,New York,79445,124036,241000,444481,0
UT,02360800,Provo College,Utah,443357,0,0,443357,0
FL,02338400,Fort Pierce Beauty Academy,Florida,443123,0,0,443123,0
PA,00336400,Saint Charles Borromeo Seminary,Pennsylvania,62584,135207,245000,442791,0
FL,03108600,Compu-Med Vocational Careers,Florida,442546,0,0,442546,0
OH,00312200,United Theological Seminary,Ohio,80709,126438,234000,441147,0
NY,02287800,National Tractor Trailer School,New York,439995,0,0,439995,0
NJ,04264400,Yeshiva Gedolah Tiferes Boruch,New Jersey,86883,128806,224000,439689,0
CA,04157800,Grace Mission University,California,61227,136645,241000,438872,0
OH,02287900,Raphael'S School Of Beauty Culture,Ohio,438150,0,0,438150,0
IL,04147200,Tricoci University Of Beauty Culture,Illinois,436904,0,0,436904,0
OR,02603700,Oregon College Of Oriental Medicine,Oregon,100095,117968,218000,436063,0
PA,02178900,Jolie Health And Beauty Academy,Pennsylvania,435974,0,0,435974,0
IL,04147500,Tricoci University Of Beauty Culture,Illinois,435780,0,0,435780,0
NY,00843700,Clinton-Essex-Warren-Washington Boces,New York,82722,128983,224000,435705,0
PR,03758300,Bayamon Community College,Puerto Rico,435133,0,0,435133,0
CA,00720300,Salon Success Academy,California,434633,0,0,434633,0
IL,02556100,Eti School Of Skilled Trades,Illinois,434609,0,0,434609,0
IL,00978600,Illinois Eastern Community Colleges - Lincoln Trail College,Illinois,434306,0,0,434306,0
MA,00552300,Blue Hills Regional Technical School,Massachusetts,84964,127079,221000,433043,0
VA,03409500,Chester Career College,Virginia,431590,0,0,431590,0
MN,00235700,Luther Seminary,Minnesota,74012,125262,232000,431274,108716000
AR,02341700,Career Academy Of Hair Design,Arkansas,429737,0,0,429737,0
TN,04238600,Gould'S Academy,Tennessee,429649,0,0,429649,0
DC,03409600,Bennett Career Institute,District of Columbia,429212,0,0,429212,0
FL,04156300,University Of Fort Lauderdale,Florida,61344,134315,233000,428659,0
OH,02301400,Ohio Valley College Of Technology,Ohio,428200,0,0,428200,0
MO,03970400,Wellspring School Of Allied Health,Missouri,428142,0,0,428142,0
PA,00658200,Washington Hospital (The),Pennsylvania,75704,127547,224000,427251,0
WV,02524500,Ralph R Willis Career And Technical Center,West Virginia,73861,105807,247000,426668,0
PR,02195500,Modern Hairstyling Institute,Puerto Rico,426601,0,0,426601,0
MO,04145700,Paul Mitchell The School Springfield,Missouri,426043,0,0,426043,0
AK,03461300,Ilisagvik College,Alaska,36806,136862,248000,421668,0
NJ,04252000,Yeshiva Gedolah Shaarei Shmuel,New Jersey,85372,121986,214000,421358,0
ID,04155200,Oliver Finley Academy Of Cosmetology,Idaho,420835,0,0,420835,0
DC,03104300,Career Technical Institute,District of Columbia,420528,0,0,420528,0
WA,02203300,Gene Juarez Beauty Schools,Washington,420399,0,0,420399,0
CA,01085400,Thomas Jefferson School Of Law,California,116684,106572,197000,420256,0
ME,00520400,Beal College,Maine,419913,0,0,419913,0
VA,03876300,Culpeper Cosmetology Training Center,Virginia,83682,119538,213000,416220,0
GA,02577000,Paul Mitchell The School - Esani,Georgia,415434,0,0,415434,0
GA,04204500,Elaine Sterling Institute(The),Georgia,414178,0,0,414178,0
OH,04124500,Mycomputercareer.Com /Techskills,Ohio,414059,0,0,414059,0
PA,00325100,Curtis Institute Of Music,Pennsylvania,86460,114363,213000,413823,253189000
NJ,00539900,Monmouth County Vocational School District,New Jersey,60651,128717,224000,413368,0
MA,02169900,Assabet Valley Regional Vocational School,Massachusetts,82100,120106,211000,413206,0
FL,04217800,Boca Beauty Academy,Florida,412160,0,0,412160,0
CO,03014900,Platt College,Colorado,412152,0,0,412152,0
AZ,04175300,Penrose Academy,Arizona,412035,0,0,412035,0
NH,10257900,New England College,New Hampshire,411295,0,0,411295,0
GA,01205100,Pro Way Hair School,Georgia,408553,0,0,408553,0
MI,04262900,Western Michigan University Homer Stryker M.D. School Of Medicine,Michigan,78563,115890,214000,408453,0
FL,03018500,Bene'S Career Academy,Florida,406818,0,0,406818,0
CA,04265500,Icohs College,California,41928,119635,243000,404563,0
FL,04194200,Aparicio-Levy Technical College,Florida,45310,126999,231000,403309,0
OH,04118300,Northcoast Medical Training Academy,Ohio,402690,0,0,402690,0
ID,04144500,Paul Mitchell The School Rexburg,Idaho,401899,0,0,401899,0
VA,03883400,Aviation Institute Of Maintenance,Virginia,401732,0,0,401732,0
NY,02173900,Ulster County Boces School Of Practical Nursing,New York,76934,110102,214000,401036,0
MO,01258000,Saint Louis Christian College,Missouri,59391,124410,217000,400801,0
NY,00643500,Arnot Ogden Medical Center,New York,79464,117203,204000,400667,0
IN,03176300,Aviation Institute Of Maintenance,Indiana,400623,0,0,400623,0
NJ,02223700,Robert Fiance Beauty Schools,New Jersey,400511,0,0,400511,0
NY,02110900,Cattaraugus/Allegany/Erie/Wyoming Boces,New York,58802,122681,217000,398483,0
GA,03100900,Luther Rice College & Seminary,Georgia,23030,135831,239000,397861,0
IN,01150500,Tricoci University Of Beauty Culture,Indiana,396317,0,0,396317,0
NY,00644800,"Ellis Medicine, The Belanger School Of Nursing",New York,78739,115012,202000,395751,0
UT,02178500,Eagle Gate College,Utah,395657,0,0,395657,0
PA,00783900,Triangle Tech,Pennsylvania,394320,0,0,394320,0
PA,02353100,Northern Tier Career Center,Pennsylvania,73110,117063,204000,394173,0
IL,02319200,Lake Forest Graduate School Of Management,Illinois,62548,116332,215000,393880,0
CA,02591600,North-West College,California,393842,0,0,393842,0
DE,04235300,Polytech Adult Education,Delaware,47434,123421,222000,392855,0
TX,02521200,Arlington Career Institute,Texas,391614,0,0,391614,0
PA,02068300,Douglas Education Center,Pennsylvania,391261,0,0,391261,0
TX,04160700,Avenue Five Institute,Texas,391249,0,0,391249,0
PA,00655100,St Margaret Memorial Hospital School Of Nursing,Pennsylvania,91302,108816,191000,391118,0
IL,02584900,First Institute,Illinois,390859,0,0,390859,0
FL,03611400,Florida Barber Academy,Florida,390387,0,0,390387,0
MO,02121100,Midwest Institute,Missouri,389911,0,0,389911,0
MO,02497500,Clinton Technical School,Missouri,75280,113774,200000,389054,0
CA,03964400,International School Of Beauty,California,386363,0,0,386363,0
NY,02171900,Ailey School (The),New York,76403,111889,197000,385292,0
CA,03225300,American University Of Health Sciences,California,384752,0,0,384752,0
WV,00904700,Huntington Junior College Of Business,West Virginia,384451,0,0,384451,0
UT,04173200,Taylor Andrews Academy Of Hair Design,Utah,383197,0,0,383197,0
AR,04256800,Arkansas Colleges Of Health Education,Arkansas,47138,117888,218000,383026,0
MI,01082700,David Pressley Professional School Of Cosmetology,Michigan,382850,0,0,382850,0
TX,02218300,Southwest School Of Business & Technical Careers,Texas,381421,0,0,381421,0
TN,02204200,"Chattanooga College - Medical, Dental And Technical Careers",Tennessee,381353,0,0,381353,0
IA,01206400,Hamilton Technical College,Iowa,380408,0,0,380408,0
CA,04220500,Butte County Regional Occupational Program,California,60515,116551,203000,380066,0
NE,01151900,Joseph'S College Cosmetology,Nebraska,379798,0,0,379798,0
OH,03117000,Ashland County - West Holmes Career Center - Adult Education,Ohio,76818,110664,192000,379482,0
WV,04212400,Mingo Extended Learning Center,West Virginia,59512,108657,211000,379169,0
OH,02528300,Tdds Technical Institute,Ohio,379013,0,0,379013,0
VA,03645400,"Rudy & Kelly Academy, A Paul Mitchell Partner School",Virginia,378939,0,0,378939,0
SC,04083300,Academy For Careers And Technology,South Carolina,64795,114788,199000,378583,0
MO,00528800,Kirksville Area Technical Center,Missouri,47216,86135,245000,378351,0
PA,01171500,Joseph F. Mccloskey School Of Nursing At Schuylkill Health,Pennsylvania,82249,107659,188000,377908,0
NV,01323200,Academy Of Hair Design,Nevada,375960,0,0,375960,0
MI,02209200,Taylortown School Of Beauty,Michigan,375859,0,0,375859,0
MN,02238100,Minnesota School Of Cosmetology,Minnesota,375857,0,0,375857,0
NY,03443300,New York College Of Traditional Chinese Medicine,New York,84673,102149,189000,375822,0
NY,04133700,New York Medical Career Training Center,New York,375729,0,0,375729,0
OH,02603800,Lorain County Jvs Adult Career Center,Ohio,35237,115755,224000,374992,0
FL,04133900,Futura Career Institute,Florida,374889,0,0,374889,0
KY,03002100,Kentucky Mountain Bible College,Kentucky,68799,111533,194000,374332,0
IL,04147100,Tricoci University Of Beauty Culture,Illinois,373874,0,0,373874,0
TX,04142300,Aveda Arts & Sciences Institute Corpus Christi,Texas,373504,0,0,373504,0
TX,04205200,Wade Gordon Hairdressing Academy,Texas,373069,0,0,373069,0
OR,01235000,Phagans' School Of Hair Design,Oregon,372489,0,0,372489,0
MO,02277500,House Of Heavilin Beauty College,Missouri,372084,0,0,372084,0
TX,00363500,Texas Chiropractic College,Texas,77399,103434,191000,371833,0
OH,00311400,Firelands Regional Medical Center,Ohio,71365,109413,191000,371778,0
OH,00311500,Rabbinical College Of Telshe,Ohio,68695,101838,201000,371533,0
PA,00405800,Gratz College,Pennsylvania,54996,111053,205000,371049,0
WV,02057400,Roane Jackson Technical Center,West Virginia,73406,108699,188000,370105,0
OK,03051100,Chisholm Trail Technology Center School District No. 26,Oklahoma,52640,113567,203000,369207,0
NJ,04216100,Yeshiva Yesodei Hatorah,New Jersey,73641,107070,188000,368711,0
MO,04170700,Paul Mitchell The School St Louis,Missouri,368274,0,0,368274,0
NY,00904300,Elmira Business Institute,New York,367057,0,0,367057,0
TX,03416500,Dallas Nursing Institute,Texas,366585,0,0,366585,0
CA,02277400,South Coast College,California,366087,0,0,366087,0
PA,02202300,Pittsburgh Career Institute,Pennsylvania,364095,0,0,364095,0
NY,02056400,Capri Cosmetology Learning Center,New York,363273,0,0,363273,0
OH,02334300,Empire Beauty School,Ohio,363192,0,0,363192,0
TN,02153100,Paul Mitchell The School Murfreesboro,Tennessee,363105,0,0,363105,0
IL,04187400,John Amico School Of Hair Design,Illinois,362538,0,0,362538,0
OH,03626300,Brown Aveda Institute,Ohio,362519,0,0,362519,0
PA,00820000,Upmc Jameson School Of Nursing,Pennsylvania,71186,106156,185000,362342,0
CT,00927700,E C Goodwin Technical High School,Connecticut,72504,101723,188000,362227,0
MA,03240300,Toni & Guy Hairdressing Academy,Massachusetts,362087,0,0,362087,0
PA,02616100,Jean Madeline Aveda Institute,Pennsylvania,361534,0,0,361534,0
OH,02563000,Raphael'S School Of Beauty Culture,Ohio,360731,0,0,360731,0
PR,04266800,Caribbean Aviation Training Institute,Puerto Rico,360410,0,0,360410,0
PA,02546200,Laurel Business Institute,Pennsylvania,360370,0,0,360370,0
MO,00245700,Concordia Seminary,Missouri,61962,104619,193000,359581,160249000
TN,02275500,Paul Mitchell The School Knoxville,Tennessee,358657,0,0,358657,0
IN,02087600,Concordia Theological Seminary,Indiana,65681,102693,190000,358374,0
IL,03914300,"Calc, Institute Of Technology",Illinois,356366,0,0,356366,0
TX,03714300,Trend Barber College,Texas,356178,0,0,356178,0
OH,03079000,Eti Technical College Of Niles,Ohio,355710,0,0,355710,0
CA,04175200,Paul Mitchell The School East Bay,California,355653,0,0,355653,0
PR,02552300,Colegio Mayor De Tecnologia,Puerto Rico,355224,0,0,355224,0
NY,02191600,Torah Temimah Talmudical Seminary,New York,66694,104416,184000,355110,0
FL,03691400,Ave Maria School Of Law,Florida,74489,98550,182000,355039,0
CA,04138700,Paul Mitchell The School - Pasadena,California,354896,0,0,354896,0
PA,03923300,Precision Manufacturing Institute,Pennsylvania,69348,104138,181000,354486,0
NY,03120700,New York Conservatory For Dramatic Arts (The),New York,354280,0,0,354280,0
NY,04267800,Bais Binyomin Academy,New York,66331,104904,183000,354235,0
TX,04231900,Alamo City Barber College,Texas,354063,0,0,354063,0
TN,03253300,Paul Mitchell The School Memphis,Tennessee,353187,0,0,353187,0
IL,04137500,Tricoci University Of Beauty Culture,Illinois,352709,0,0,352709,0
TX,04260900,Mystros Barber Academy,Texas,58383,89101,205000,352484,0
FL,04106300,Palm Beach Academy Of Health & Beauty,Florida,352289,0,0,352289,0
VA,04137300,Cayce/Reilly School Of Massage,Virginia,61587,105979,184000,351566,0
PR,02166000,Centro De Estudios Avanzados De Puerto Rico Y El Caribe,Puerto Rico,36954,110226,204000,351180,0
MO,01040500,Pinnacle Career Institute,Missouri,349930,0,0,349930,0
TN,00778300,Middle Tennessee School Of Anesthesia,Tennessee,56794,102676,190000,349470,0
FL,04170300,Beauty Academy Of South Florida,Florida,348763,0,0,348763,0
WI,00385000,Holy Family College,Wisconsin,348751,0,0,348751,0
MI,02125600,Michigan College Of Beauty-Troy,Michigan,348449,0,0,348449,0
GA,03102000,"Rivertown School Of Beauty, Barber, Skin Care And Nails",Georgia,348039,0,0,348039,0
FL,04145900,Celebrity School Of Beauty,Florida,347719,0,0,347719,0
IL,02261200,G Skin & Beauty Institute,Illinois,347284,0,0,347284,0
MI,00224200,Calvin Theological Seminary,Michigan,71301,96593,179000,346894,0
NE,02610500,Xenon International Academy Ii,Nebraska,346579,0,0,346579,0
MD,03327300,Hair Academy Ii,Maryland,345610,0,0,345610,0
NY,02505900,Shor Yoshuv Rabbinical College,New York,59797,101440,184000,345237,0
KY,02535600,Clear Creek Baptist Bible College,Kentucky,41384,110307,192000,343691,0
VA,04144000,Fairfax University Of America,Virginia,78295,93380,172000,343675,0
WI,03808300,Institute Of Beauty And Wellness (The),Wisconsin,343456,0,0,343456,0
NJ,03077500,Rabbi Jacob Joseph School,New Jersey,72804,98114,172000,342918,0
NY,04144300,Institute Of Culinary Education,New York,341532,0,0,341532,0
AZ,03347300,International Baptist College And Seminary,Arizona,70347,98089,172000,340436,0
NM,03678300,Pima Medical Institute,New Mexico,340233,0,0,340233,0
MA,03248300,Boston Baptist College,Massachusetts,61817,101261,177000,340078,0
PA,00329100,United Lutheran Seminary,Pennsylvania,56158,99382,184000,339540,0
AZ,03593300,Southwest Institute Of Healing Arts,Arizona,339100,0,0,339100,0
CO,04170200,Paul Mitchell The School Colorado Springs,Colorado,338720,0,0,338720,0
CA,04259800,California Institute Of Arts & Technology,California,338044,0,0,338044,0
CA,04256500,Baldy View Regional Occupational Program,California,61625,99194,177000,337819,0
FL,04116600,Taylor College,Florida,337759,0,0,337759,0
GA,03104500,Atlanta Institute Of Music And Media,Georgia,337362,0,0,337362,0
OH,04225700,Cleveland Barber College,Ohio,337078,0,0,337078,0
IN,04256200,Kenny'S Academy Of Barbering,Indiana,335777,0,0,335777,0
TX,03412300,Advanced Barber College & Hair Design,Texas,335473,0,0,335473,0
NY,02145800,Cayuga Onondaga Boces,New York,59419,100658,175000,335077,0
GA,03804400,Gwinnett College,Georgia,334880,0,0,334880,0
PA,04151700,Bella Capelli Academy A Paul Mitchell Partner School,Pennsylvania,334723,0,0,334723,0
AL,04229400,Midfield Institute Of Cosmetology,Alabama,38911,93012,202000,333923,0
MO,03066300,Bryan University,Missouri,333687,0,0,333687,0
LA,03727500,Moore Career College,Louisiana,332337,0,0,332337,0
NJ,04207500,Medical Career Institute,New Jersey,332030,0,0,332030,0
IL,00162800,American Academy Of Art,Illinois,331941,0,0,331941,0
NY,04233700,"Christine Valmy International School Foresthetics, Skin Care & Make-Up",New York,331195,0,0,331195,0
CA,04132700,Healthcare Career College,California,331157,0,0,331157,0
TX,03032300,School Of Automotive Machinists & Technology,Texas,330911,0,0,330911,0
GA,04256700,Reformed University,Georgia,70509,93560,166000,330069,0
CA,03681300,California Healing Arts College,California,329263,0,0,329263,0
WV,02609400,Valley College,West Virginia,328669,0,0,328669,0
NY,00397400,Mesivtha Tifereth Jerusalem Of America,New York,66112,95479,167000,328591,0
CA,04250100,Santa Barbara And Ventura Colleges Of Law (The),California,54315,101170,173000,328485,0
NC,01192600,Leon'S Beauty School,North Carolina,328351,0,0,328351,0
TN,03061100,Genesis Career College,Tennessee,328276,0,0,328276,0
TN,03355400,Richmont Graduate University,Tennessee,62656,92894,172000,327550,0
NJ,01152300,Morris County School Of Technology,New Jersey,68148,94184,165000,327332,0
MD,00826300,Award Beauty School,Maryland,327046,0,0,327046,0
MD,04265200,Women'S Institute Of Torah Seminary,Maryland,61745,96119,169000,326864,0
CA,00128800,Claremont School Of Theology,California,66104,91565,169000,326669,0
CA,03097700,Central California School Of Continuing Education,California,326010,0,0,326010,0
NJ,04261200,Yeshiva Bais Aharon,New Jersey,64039,95577,166000,325616,0
CT,02316600,Cortiva Institute,Connecticut,325544,0,0,325544,0
LA,02258400,Aveda Arts & Sciences Institute Baton Rouge,Louisiana,325463,0,0,325463,0
OR,00320300,Mount Angel Seminary,Oregon,71691,90729,163000,325420,0
FL,00466600,American College For Medical Careers,Florida,323870,0,0,323870,0
IL,02317300,Tricoci University Of Beauty Culture,Illinois,323319,0,0,323319,0
TX,02224600,Tri-State Cosmetology Institute,Texas,322549,0,0,322549,0
WV,02068000,United Technical Center,West Virginia,57801,87433,177000,322234,0
FL,04158300,Flagler Technical Institute,Florida,33483,101733,187000,322216,0
CA,02064300,Sierra College Of Beauty,California,321871,0,0,321871,0
KS,04132900,Z Hair Academy,Kansas,321716,0,0,321716,0
NJ,04269300,Yeshiva Gedolah Of Cliffwood,New Jersey,64764,92377,164000,321141,0
NC,03009500,Winston - Salem Barber School,North Carolina,320870,0,0,320870,0
NY,00928400,Brittany Beauty School -,New York,320102,0,0,320102,0
CA,04164400,Angeles Institute,California,319593,0,0,319593,0
NJ,03803300,Healthcare Training Institute,New Jersey,319461,0,0,319461,0
NY,01161700,Center For Allied Health Education,New York,318982,0,0,318982,0
KS,04209300,Paul Mitchell The School Overland Park,Kansas,318952,0,0,318952,0
MO,02568500,Grabber School Of Hair Design,Missouri,318144,0,0,318144,0
IL,03065300,Paul Mitchell The School Bradley,Illinois,317512,0,0,317512,0
WA,03283300,Northwest Hvac/R Association & Training,Washington,62732,92612,161000,316344,0
MN,03051900,Adler Graduate School,Minnesota,53819,92142,170000,315961,0
TX,03371300,Toni&Guy Hairdressing Academy I Tigi Creative School,Texas,313195,0,0,313195,0
OH,02066100,Ohio State College Of Barber Styling,Ohio,312642,0,0,312642,0
NY,00933500,Mesivta Of Eastern Parkway Rabbinical Seminary,New York,60547,91870,160000,312417,0
NY,00902900,Neighborhood Playhouse School Of The Theatre (The),New York,60982,86156,165000,312138,0
NY,02105900,Brittany Beauty Academy,New York,312065,0,0,312065,0
CA,04208900,Advanced Career Institute,California,311065,0,0,311065,0
CA,01202600,Bellus Academy,California,310881,0,0,310881,0
IL,04117600,Larry'S Barber College,Illinois,310874,0,0,310874,0
CA,03935300,California Nurses Educational Institute,California,309864,0,0,309864,0
OH,02210800,Medina County Joint Vocational School,Ohio,38825,99016,172000,309841,0
NY,02622900,Rabbinical College Of Yeshiva And Kolel Bais Medrosh Elyon Association,New York,60982,89412,159000,309394,0
TX,04215400,Grace School Of Theology,Texas,32732,98060,177000,307792,0
WA,04155000,Northwest School Of Wooden Boat Building,Washington,63564,79027,165000,307591,0
NY,01278300,Oswego County Boces,New York,125152,182318,0,307470,0
FL,04209200,South Dade Technical College-South Dade Skills Center Campus,Florida,83362,223849,0,307211,0
SC,03746400,Southeastern Institute,South Carolina,306951,0,0,306951,0
AZ,04174100,Paul Mitchell The School Phoenix,Arizona,306817,0,0,306817,0
PR,03785300,Cambridge Technical Institute,Puerto Rico,306689,0,0,306689,0
OH,03837300,Aveda Fredric'S Institute,Ohio,306542,0,0,306542,0
MI,03907300,Paul Mitchell The School Great Lakes,Michigan,306375,0,0,306375,0
CO,04221400,Paul Mitchell The School Denver,Colorado,306368,0,0,306368,0
OK,00970800,Eve'S College Of Hairstyling,Oklahoma,305703,0,0,305703,0
NJ,01209000,Robert Fiance Beauty Schools,New Jersey,304898,0,0,304898,0
PR,03552300,Leston College,Puerto Rico,304702,0,0,304702,0
GA,00156000,Columbia Theological Seminary,Georgia,68698,82724,153000,304422,224956000
PR,04267000,Neo-Esthetique European Institute,Puerto Rico,304166,0,0,304166,0
ME,04185100,Northeast Technical Institute,Maine,303535,0,0,303535,0
IL,04147300,Tricoci University Of Beauty Culture,Illinois,303260,0,0,303260,0
OH,03425300,Rosedale Bible College,Ohio,54367,90756,158000,303123,0
MA,03104000,Shawsheen Valley School Of Practical Nursing,Massachusetts,56964,83811,162000,302775,0
KY,02340800,Paul Mitchell The School Lexington,Kentucky,302711,0,0,302711,0
TX,02239100,Central Texas Beauty College 2,Texas,302581,0,0,302581,0
OK,04240500,Paul Mitchell The School Tulsa,Oklahoma,302285,0,0,302285,0
MA,04122000,Tri County Regional Vocational Technical High School,Massachusetts,61619,87360,153000,301979,0
FL,03939600,Daytona College,Florida,301333,0,0,301333,0
NV,04203100,Paul Mitchell The School Reno,Nevada,300897,0,0,300897,0
ME,04177400,Capilo School Of Hair Design,Maine,300391,0,0,300391,0
CA,03063400,Modern Technology School,California,300190,0,0,300190,0
MA,01218700,Blackstone Valley Vocational Regional School District,Massachusetts,43819,93302,162000,299121,0
GA,02580200,Atlanta School Of Massage,Georgia,298408,0,0,298408,0
IN,02241700,Pj'S College Of Cosmetology,Indiana,297401,0,0,297401,0
MO,00543800,Saline County Career Center,Missouri,52890,78106,166000,296996,0
PR,04251000,Inter American University Of Puerto Rico - School Of Optometry,Puerto Rico,66924,80734,149000,296658,0
MO,02056100,Four Rivers Career Center,Missouri,57399,87143,152000,296542,0
FL,04163200,Tenaj Salon Institute,Florida,296389,0,0,296389,0
VA,04180600,Appalachian College Of Pharmacy,Virginia,61104,82299,152000,295403,0
IL,00168200,Garrett - Evangelical Theological Seminary,Illinois,54902,84124,156000,295026,0
LA,04040300,Compass Career College,Louisiana,294870,0,0,294870,0
CA,00998900,California Aeronautical University,California,294711,0,0,294711,0
IL,02498200,G Skin & Beauty Institute,Illinois,294614,0,0,294614,0
MI,03075200,Twin City Beauty College,Michigan,294015,0,0,294015,0
ME,00205500,University Of Maine - Machias,Maine,293556,0,0,293556,0
WA,04191900,Paul Mitchell The School Spokane,Washington,293175,0,0,293175,0
PR,02482400,Ponce Health Sciences University,Puerto Rico,292489,0,0,292489,0
NY,00289000,Union Theological Seminary,New York,59416,81565,151000,291981,112560000
CA,04141300,San Francisco Institute Of Esthetics & Cosmetology,California,291524,0,0,291524,0
MA,02523900,Elizabeth Grady School Of Esthetics And Massage Therapy,Massachusetts,291436,0,0,291436,0
IN,02084800,Ravenscroft Beauty College,Indiana,291246,0,0,291246,0
NM,04162400,Toni&Guy Hairdressing Academy,New Mexico,290981,0,0,290981,0
OH,02568600,Mahoning County Career And Technical Center,Ohio,37149,86271,166000,289420,0
RI,04141200,Toni & Guy Hairdressing Academy,Rhode Island,289022,0,0,289022,0
IL,00169800,John Marshall Law School (The),Illinois,288952,0,0,288952,0
CA,02258600,Avalon School Of Cosmetology,California,288531,0,0,288531,0
SD,00405600,North American Baptist Seminary,South Dakota,37001,88162,163000,288163,0
WI,04117400,Milwaukee Career College,Wisconsin,288092,0,0,288092,0
CA,04237100,Salon Professional Academy (The),California,287982,0,0,287982,0
FL,04197600,"Florida Institute Of Recording, Sound And Technology",Florida,287242,0,0,287242,0
WA,03466400,Seattle School Of Theology And Psychology (The),Washington,58777,80079,148000,286856,0
IN,04155900,Aveda Fredric'S Institute,Indiana,286480,0,0,286480,0
CA,03109500,Dongguk University Los Angeles,California,60458,80008,146000,286466,0
MS,04131300,Corinth Academy Of Cosmetology,Mississippi,286443,0,0,286443,0
MN,02514100,Takoda Institute Of Higher Education,Minnesota,42315,87371,156000,285686,0
PA,02206300,Beauty Institute (The),Pennsylvania,285213,0,0,285213,0
MI,03588300,Irene'S Myomassology Institute,Michigan,284945,0,0,284945,0
FL,03256300,Yeshiva Gedolah Rabbinical College,Florida,55254,83524,146000,284778,0
VA,03654300,Eastern Virginia Career College,Virginia,284478,0,0,284478,0
IA,00185800,Divine Word College,Iowa,52060,84341,148000,284401,0
NC,04140700,Aveda Institute Chapel Hill,North Carolina,284390,0,0,284390,0
FL,03856500,Florida School Of Traditional Midwifery,Florida,35271,90982,158000,284253,0
OH,04126000,Paul Mitchell The School Cleveland,Ohio,284158,0,0,284158,0
PA,02362300,Mercer County Career Center,Pennsylvania,39531,82328,162000,283859,0
NJ,04270300,Yeshivas Emek Hatorah,New Jersey,56454,82397,145000,283851,0
CA,03299300,Pacific College,California,283666,0,0,283666,0
FL,03414500,Acupuncture And Massage College,Florida,283101,0,0,283101,0
IL,02124400,University Of Spa & Cosmetology Arts,Illinois,281764,0,0,281764,0
AL,02285000,Paul Mitchell The School Huntsville,Alabama,280920,0,0,280920,0
VA,04241500,Wave Leadership College,Virginia,47516,84520,148000,280036,0
CA,03868400,Los Angeles College Of Music,California,279751,0,0,279751,0
PA,01005500,Crawford County Career & Technical Center,Pennsylvania,49853,67542,162000,279395,0
IL,02074400,Illinois Eastern Community Colleges -Frontier Community College,Illinois,279328,0,0,279328,0
NY,00267400,New York Theological Seminary,New York,45974,81879,151000,278853,0
MA,00555700,C H Mccann Technical School,Massachusetts,54800,81488,142000,278288,0
MI,04014300,P&A Scholars Beauty School,Michigan,278254,0,0,278254,0
OH,04153300,Paul Mitchell The School Columbus,Ohio,278089,0,0,278089,0
CA,03039900,Fremont College,California,277847,0,0,277847,0
LA,02117800,Aveda Arts & Sciences Institute Lafayette,Louisiana,277500,0,0,277500,0
TN,00885900,John A Gupton College,Tennessee,36947,87146,153000,277093,0
CA,01301000,Lancaster Beauty School,California,276907,0,0,276907,0
NJ,04218500,Innovate Salon Academy,New Jersey,276460,0,0,276460,0
CT,02112700,"North Haven Academy, Llc",Connecticut,276333,0,0,276333,0
NJ,04136400,American Institute Of Medical Sciences & Education,New Jersey,276285,0,0,276285,0
DE,02125200,Margaret H. Rollins School Of Nursing At Beebe Medical Center,Delaware,49412,82625,144000,276037,0
LA,04151600,My-Le'S Beauty College,Louisiana,275942,0,0,275942,0
TX,02530700,Sebring Career Schools,Texas,275383,0,0,275383,0
OH,02553000,Modern College Of Design (The),Ohio,274561,0,0,274561,0
MA,02220400,Catherine Hinds Institute Of Esthetics,Massachusetts,274119,0,0,274119,0
PR,04131600,Liberty Junior College,Puerto Rico,274020,0,0,274020,0
CT,04219200,Ace Cosmetology & Barbering Training Center,Connecticut,273453,0,0,273453,0
FL,04192100,American Medical Academy,Florida,273262,0,0,273262,0
TX,03092600,Messenger College,Texas,41759,84135,146000,271894,0
AL,04149200,Xcell Academy A Paul Mitchell School,Alabama,271411,0,0,271411,0
UT,04210300,Medspa Academies,Utah,270463,0,0,270463,0
NY,02104300,Otsego Delaware Schoharie Greene Boces,New York,54054,78807,137000,269861,0
MO,02564700,Elaine Steven Beauty College,Missouri,269098,0,0,269098,0
OH,03095600,Ohio Technical Center At Vantage Career Center,Ohio,20672,89410,159000,269082,0
OH,00311300,Pontifical College Josephinum,Ohio,63175,73352,132000,268527,0
GA,03418300,Gwinnett College-Sandy Springs,Georgia,268254,0,0,268254,0
RI,03732300,Iyrs School Of Technology & Trades,Rhode Island,54919,66281,147000,268200,0
TX,01013000,Wade College,Texas,268048,0,0,268048,0
TX,03035200,Tint School Of Makeup & Cosmetology,Texas,267928,0,0,267928,0
NJ,01090300,Rizzieri Aveda School For Beauty And Wellness,New Jersey,267582,0,0,267582,0
MO,00246700,Conception Seminary College,Missouri,52627,77941,137000,267568,0
DE,03543300,Harris School Of Business,Delaware,267318,0,0,267318,0
CA,03458300,My Le'S Beauty College,California,266867,0,0,266867,0
IN,01061800,Mid America College Of Funeral Service,Indiana,9117,93670,164000,266787,0
OR,02311000,Paul Mitchell The School Portland,Oregon,266631,0,0,266631,0
TX,03021500,Nuvani Institute,Texas,266603,0,0,266603,0
IL,00923200,Catholic Theological Union At Chicago,Illinois,47654,76643,142000,266297,0
IL,04147400,Tricoci University Of Beauty Culture,Illinois,265804,0,0,265804,0
MD,02343800,Montgomery Beauty School,Maryland,265117,0,0,265117,0
OH,03116400,Vanguard - Sentinel Joint Vocational School District,Ohio,39503,82013,142000,263516,0
CA,00120700,Graduate Theological Union,California,59068,71509,132000,262577,51475000
PA,00865300,Jefferson County Dubois Area Vocational Techl School Practical Nursing,Pennsylvania,49739,77543,135000,262282,0
CO,04218900,Rocky Vista University,Colorado,262167,0,0,262167,0
GA,00156800,Interdenominational Theological Center,Georgia,44417,76484,141000,261901,0
IL,03510300,Erikson Institute,Illinois,41187,77375,143000,261562,46655000
NY,01183000,Berk Trade & Business School,New York,261450,0,0,261450,0
CO,03670300,Toni&Guy Hairdressing Academy,Colorado,261110,0,0,261110,0
WA,01293200,Tint School Of Makeup & Cosmetology,Washington,260547,0,0,260547,0
NY,04223800,Electrical And Hvac/R Training Center,New York,259836,0,0,259836,0
CA,04092400,Make-Up Designory,California,258613,0,0,258613,0
KY,02351700,Paul Mitchell The School - Louisville,Kentucky,258448,0,0,258448,0
CA,02125000,Career Academy Of Beauty,California,258413,0,0,258413,0
MO,00543000,Poplar Bluff Technical Career Center,Missouri,50853,75842,131000,257695,0
CA,04122800,Presbyterian Theological Seminary In America,California,41486,77487,138000,256973,0
KS,04162700,Eric Fisher Academy,Kansas,256675,0,0,256675,0
NV,04144800,International Academy Of Style,Nevada,256631,0,0,256631,0
CA,03098200,Yo San University Of Traditional Chinese Medicine,California,59068,69405,128000,256473,0
PA,03535300,Huntingdon County Career And Technology Center,Pennsylvania,45583,73381,137000,255964,0
CA,04221900,California Technical Academy,California,255559,0,0,255559,0
IL,00893800,Graham Hospital School Of Nursing,Illinois,39279,78903,137000,255182,0
NJ,04181400,Best Care College,New Jersey,255167,0,0,255167,0
CA,03116600,East San Gabriel Valley Rop And Technical Center,California,255012,0,0,255012,0
OH,00510200,School Of Diagnostic Imaging-Cleveland Clinic Health System,Ohio,48618,72952,133000,254570,0
TX,03276300,Academy Of Hair Design,Texas,253226,0,0,253226,0
IA,00758800,Capri College,Iowa,253210,0,0,253210,0
CA,04227100,America Evangelical University,California,33544,79214,140000,252758,0
PA,04175900,Geisinger-Lewistown Hospital School Of Nursing,Pennsylvania,32817,79881,140000,252698,0
IA,02090300,Capri College,Iowa,252527,0,0,252527,0
TX,04146800,South Texas Training Center,Texas,252140,0,0,252140,0
MO,00528900,Waynesville Career Center,Missouri,53380,70502,128000,251882,0
TN,00956700,Tennessee School Of Beauty,Tennessee,251557,0,0,251557,0
MO,02142200,Lex La Ray Technical Center,Missouri,44826,74849,131000,250675,0
AR,03005100,Arkansas Beauty School- Little Rock,Arkansas,250493,0,0,250493,0
AR,03023400,Arkansas College Of Barbering & Hair Design,Arkansas,249875,0,0,249875,0
TN,02275000,Jenny Lea Academy Of Cosmetology,Tennessee,249743,0,0,249743,0
NE,02079700,College Of Hair Design,Nebraska,249536,0,0,249536,0
VA,01159600,Sylvain Melloul International Hair Academy,Virginia,248788,0,0,248788,0
MI,02198900,Michigan School Of Psychology,Michigan,43937,71594,132000,247531,0
AZ,03478400,Phoenix Seminary,Arizona,42117,71977,133000,247094,0
MI,00761700,Carnegie Institute,Michigan,246994,0,0,246994,0
KY,01042400,Summit Salon Academy,Kentucky,246137,0,0,246137,0
OH,04177300,Ohio Medical Career College,Ohio,246076,0,0,246076,0
CA,03532400,Ata College,California,246006,0,0,246006,0
FL,03985300,Cda Technical Institute,Florida,245723,0,0,245723,0
WA,00973900,Glen Dow Academy Of Hair Design & Salons,Washington,245537,0,0,245537,0
PA,04041300,Berks Career & Technology Center,Pennsylvania,35466,76488,133000,244954,0
MO,04174800,American Trade School,Missouri,244354,0,0,244354,0
PA,02323000,Missio Theological Seminary,Pennsylvania,45643,69688,129000,244331,0
TX,04226400,Mt Training Center,Texas,244174,0,0,244174,0
NY,02575400,International Culinary Center,New York,244131,0,0,244131,0
WY,00915700,Wyotech,Wyoming,243773,0,0,243773,0
CA,02285100,Hilltop Beauty School,California,243264,0,0,243264,0
OH,01170300,Penta County Vocational School,Ohio,39934,74315,129000,243249,0
CA,02553500,Associated Technical College,California,243114,0,0,243114,0
TX,04235900,Bella Cosmetology And Barber College,Texas,242664,0,0,242664,0
TX,01229700,Laredo Beauty College,Texas,241660,0,0,241660,0
CA,03332300,Southern California Seminary,California,39208,73395,129000,241603,0
CA,02543400,Brownson Technical School,California,241003,0,0,241003,0
CT,00138900,Holy Apostles College & Seminary,Connecticut,22522,78426,140000,240948,0
NY,04155300,Onondaga School Of Therapeutic Massage,New York,240765,0,0,240765,0
AZ,02491500,Southwest University Of Visual Arts,Arizona,239538,0,0,239538,0
CA,04211900,Xavier College School Of Nursing,California,238863,0,0,238863,0
UT,04184200,Taylor Andrews Academy-St. George,Utah,238549,0,0,238549,0
FL,04242000,Latin Beauty Academy,Florida,238057,0,0,238057,0
CA,04160400,Angeles College,California,237819,0,0,237819,0
IN,04172700,Salon Professional Academy (The),Indiana,237818,0,0,237818,0
NM,04174500,Aveda Institute Of New Mexico (The),New Mexico,237641,0,0,237641,0
CA,01186500,California Hair Design Academy,California,237120,0,0,237120,0
NC,04204700,Paul Mitchell The School Raleigh,North Carolina,237073,0,0,237073,0
HI,04175100,Paul Mitchell The School Honolulu,Hawaii,237042,0,0,237042,0
CA,04092300,Coastline Beauty College,California,236995,0,0,236995,0
OH,02497800,Greene County Career Center,Ohio,37198,72515,127000,236713,0
PR,03735400,"Charlie'S Guard, Detective Bureau, And Academy",Puerto Rico,236171,0,0,236171,0
AK,00884300,Alaska Bible College,Alaska,42068,70715,123000,235783,0
NY,04166000,Manhattan Institute (The),New York,235112,0,0,235112,0
PR,02562500,International Technical College,Puerto Rico,234857,0,0,234857,0
IN,00967300,Rudae'S School Of Beauty Culture,Indiana,234658,0,0,234658,0
OH,03067600,Raphael'S School Of Beauty Culture,Ohio,234526,0,0,234526,0
NC,03827300,Charlotte Christian College And Theological Seminary,North Carolina,32851,73494,128000,234345,0
FL,02573200,La Belle Beauty Academy,Florida,234070,0,0,234070,0
CA,04115300,Coachella Valley Beauty College,California,233574,0,0,233574,0
IN,00727600,Saint Meinrad School Of Theology,Indiana,40897,67572,125000,233469,0
CA,01298400,Professional Institute Of Beauty,California,233396,0,0,233396,0
CO,01300700,Nazarene Bible College,Colorado,5757,82244,145000,233001,0
FL,00807500,St. John Vianney College Seminary,Florida,38046,70351,124000,232397,0
NJ,04266000,Bais Medrash Mayan Hatorah,New Jersey,46377,66870,119000,232247,0
VA,03010700,Paul Mitchell The School Roanoke,Virginia,232095,0,0,232095,0
ME,02361300,The Landing School Of Boatbuilding & Design,Maine,43850,67707,120000,231557,0
IA,04203300,Aveda Institute Des Moines,Iowa,231383,0,0,231383,0
CT,04104300,Academy Di Capelli,Connecticut,230964,0,0,230964,0
UT,03463300,Careers Unlimited,Utah,230510,0,0,230510,0
WV,03084400,Valley College,West Virginia,230104,0,0,230104,0
MS,02320800,Magnolia College Of Cosmetology,Mississippi,229881,0,0,229881,0
CA,02595600,Asian-American International Beauty College,California,229596,0,0,229596,0
CA,04144200,Career Development Institute,California,228785,0,0,228785,0
NE,00961700,Capitol School Of Hairstyling And Esthetics,Nebraska,228346,0,0,228346,0
FL,04105400,Pensacola School Of Massage Therapy & Health Careers,Florida,228149,0,0,228149,0
WV,01014000,Mineral County Vocational Technical Center,West Virginia,40808,68137,119000,227945,0
KS,02603100,Crave Beauty Academy,Kansas,227937,0,0,227937,0
SD,01013800,Stewart School,South Dakota,227595,0,0,227595,0
CA,04076400,Gnomon,California,226588,0,0,226588,0
WA,04250400,Fosbre Academy Of Hair Design,Washington,226584,0,0,226584,0
PA,03081900,Yti Career Institute - Altoona,Pennsylvania,225942,0,0,225942,0
NM,03076100,Southwestern College,New Mexico,45392,63334,117000,225726,0
CA,00713000,Newberry School Of Beauty,California,225726,0,0,225726,0
CA,03125300,John Wesley International Barber And Beauty College,California,225673,0,0,225673,0
PA,00335600,Pittsburgh Theological Seminary,Pennsylvania,40736,64694,120000,225430,0
CA,03288300,Academy Of Chinese Culture And Health Sciences,California,49465,61806,114000,225271,0
PA,04155100,Institute Of Medical And Business Careers,Pennsylvania,225111,0,0,225111,0
OK,02184400,Jenks Beauty College,Oklahoma,224888,0,0,224888,0
IL,00176500,University Of Saint Mary Of The Lake,Illinois,43064,63728,118000,224792,0
FL,03557300,North Florida Cosmetology Institute,Florida,224742,0,0,224742,0
FL,04130400,Shear Excellence Hair Academy,Florida,224489,0,0,224489,0
FL,04163000,Summit Salon Academy,Florida,224446,0,0,224446,0
PR,02593700,Richport Technical College,Puerto Rico,223803,0,0,223803,0
KS,02134800,Old Town Barber College,Kansas,223567,0,0,223567,0
PA,03766300,Cortiva Institute,Pennsylvania,223392,0,0,223392,0
UT,04193200,Rocky Mountain University Of Health Professions,Utah,223276,0,0,223276,0
WY,02211900,Cheeks Beauty Academy,Wyoming,223185,0,0,223185,0
TX,02318200,Kd Conservatory College Of Film And Dramatic Arts,Texas,223164,0,0,223164,0
IA,00771700,Capri College,Iowa,222923,0,0,222923,0
LA,00989800,Avery James School Of Cosmetology,Louisiana,222638,0,0,222638,0
PA,01313400,Yeshivath Beth Moshe,Pennsylvania,44687,64944,113000,222631,0
NM,04276000,Glitz School Of Cosmetology,New Mexico,222535,0,0,222535,0
CA,04223700,Bay Area Medical Academy,California,222337,0,0,222337,0
CA,01307400,American Beauty College,California,221903,0,0,221903,0
KY,04249000,Medical Career And Technical College,Kentucky,221558,0,0,221558,0
NY,04206200,Digital Film Academy,New York,221487,0,0,221487,0
MI,00225400,Michigan State University College Of Law,Michigan,221124,0,0,221124,0
LA,00462100,Ayers Career College,Louisiana,220509,0,0,220509,0
IN,04100300,Denmark College,Indiana,219869,0,0,219869,0
VA,04235400,Saint Michael College Of Allied Health,Virginia,219720,0,0,219720,0
NY,04213500,Sharp Edgez Barber Institute,New York,219572,0,0,219572,0
MO,01102600,Warrensburg Area Career Center,Missouri,46106,63356,110000,219462,0
TX,04178200,Vogue College - San Antonio,Texas,219075,0,0,219075,0
OH,02168100,Tri County Career Center/Adult Career Center,Ohio,22236,71019,125000,218255,0
DC,04114400,Institute Of World Politics (The),District of Columbia,37536,63272,117000,217808,0
FL,04188300,Florida Academy,Florida,217593,0,0,217593,0
TX,03682400,Dallas Barber & Stylist College,Texas,217481,0,0,217481,0
TX,00359500,Oblate School Of Theology,Texas,39831,62182,115000,217013,0
CA,02537200,Palomar Institute Of Cosmetology,California,216046,0,0,216046,0
CA,04191300,Annenberg School Of Nursing,California,37770,65199,113000,215969,0
CA,04237600,California Jazz Conservatory,California,38567,64325,113000,215892,0
MN,04130200,Institute Of Production And Recording (The),Minnesota,215678,0,0,215678,0
MA,00221400,Saint John'S Seminary,Massachusetts,50920,57709,107000,215629,0
MO,00855200,Stevens - The Institute Of Business & Arts,Missouri,214565,0,0,214565,0
NY,02152000,Yeshiva Shaar Hatorah,New York,43952,61551,109000,214503,0
CT,04152400,International Institute Of Cosmetology,Connecticut,214064,0,0,214064,0
SD,02297800,Headlines Academy,South Dakota,213757,0,0,213757,0
WV,01174900,Wood County Technical Center,West Virginia,37341,64175,112000,213516,0
CA,02520400,Adrians Beauty College Of Turlock,California,213440,0,0,213440,0
WV,00760000,International Beauty School,West Virginia,213159,0,0,213159,0
MA,02122000,New England Hair Academy,Massachusetts,213149,0,0,213149,0
CT,04145400,Oxford Academy Of Hair Design,Connecticut,212940,0,0,212940,0
AR,02363500,Arthur'S Beauty College,Arkansas,212858,0,0,212858,0
MS,03963300,Institute Of Health And Technology,Mississippi,212413,0,0,212413,0
CA,02500000,San Joaquin College Of Law,California,42482,59275,110000,211757,0
NJ,02234600,Atlantic Beauty & Spa Academy,New Jersey,211628,0,0,211628,0
NY,01094300,Rabbinical College Beth Shraga,New York,43268,61178,107000,211446,0
CA,04215100,California Career Institute,California,211121,0,0,211121,0
NH,00864500,Empire Beauty Schools,New Hampshire,211058,0,0,211058,0
PR,02504500,Mayagüez Institute Of Technology,Puerto Rico,210943,0,0,210943,0
IL,00825900,Educators Of Beauty College Of Cosmetology,Illinois,210787,0,0,210787,0
IN,04184000,Paul Mitchell The School Indianapolis,Indiana,210143,0,0,210143,0
IL,00172100,Mccormick Theological Seminary,Illinois,32880,62124,115000,210004,78025000
IL,03891300,Soma Institute - The National School Of Clinical Massage Therapy,Illinois,209436,0,0,209436,0
AZ,04120900,Arizona Culinary Institute,Arizona,209341,0,0,209341,0
TN,01052900,Memphis Theological Seminary,Tennessee,36663,60641,112000,209304,0
FL,03433400,New Concept Massage & Beauty School,Florida,209257,0,0,209257,0
MS,02244300,Mississippi Barber Academy,Mississippi,209055,0,0,209055,0
MO,03077200,Paul Mitchell The School Missouri Columbia,Missouri,208917,0,0,208917,0
FL,04229800,Gadsden Technical Institute,Florida,41133,60783,107000,208916,0
KS,02257700,Hays Academy Of Hair Design,Kansas,208816,0,0,208816,0
TX,04125400,Paul Mitchell The School Austin,Texas,208605,0,0,208605,0
TX,01226800,Baldwin Beauty Schools,Texas,208482,0,0,208482,0
CA,02578000,Santa Barbara Business College,California,208381,0,0,208381,0
NY,04228300,Paul Mitchell The School Schenectady,New York,207766,0,0,207766,0
MS,02074900,Chris' Beauty College,Mississippi,206812,0,0,206812,0
CA,04274900,Contra Costa Medical Career College,California,206180,0,0,206180,0
TN,04165000,Meridian Institute Of Surgical Assisting,Tennessee,205301,0,0,205301,0
CA,03126800,Pacifica Graduate Institute,California,204263,0,0,204263,0
UT,04145500,Skin Science Institute Of Laser & Esthetics,Utah,204214,0,0,204214,0
TN,02539800,Queen City College,Tennessee,203636,0,0,203636,0
CO,04185000,Colorado Academy Of Veterinary Technology,Colorado,203310,0,0,203310,0
FL,02257900,International Academy,Florida,203011,0,0,203011,0
TX,02600200,Ocean Corporation (The),Texas,203004,0,0,203004,0
UT,03921300,Cameo College Of Essential Beauty,Utah,202759,0,0,202759,0
NC,03361300,Gwinnett College,North Carolina,202040,0,0,202040,0
VA,03559300,Appalachian School Of Law,Virginia,41609,56349,104000,201958,0
UT,03909300,Paul Mitchell The School Logan,Utah,201857,0,0,201857,0
AR,04183100,Washington Barber College,Arkansas,201847,0,0,201847,0
NJ,01085100,Branford Hall Career Institute,New Jersey,201705,0,0,201705,0
OR,04251300,Pacific Bible College,Oregon,23644,64530,113000,201174,0
PA,02144000,Beauty Institute (The),Pennsylvania,201004,0,0,201004,0
IL,04160600,Paul Mitchell The School Normal,Illinois,200795,0,0,200795,0
CA,04175400,Elite Cosmetology School,California,200776,0,0,200776,0
PR,03106900,Escuela De Peritos Electricistas De Isabela,Puerto Rico,200249,0,0,200249,0
WI,04165300,Paul Mitchell The School Milwaukee,Wisconsin,200128,0,0,200128,0
IL,04189600,State Career School,Illinois,199410,0,0,199410,0
CA,04242500,Associated Barber College Of San Diego,California,199340,0,0,199340,0
CA,04249600,Westcliff University,California,199036,0,0,199036,0
NV,02237500,Las Vegas College,Nevada,198868,0,0,198868,0
DE,02190400,Schilling - Douglas School Of Hair Design,Delaware,198790,0,0,198790,0
WI,01148400,Advanced Institute Of Hair Design,Wisconsin,198701,0,0,198701,0
CA,04159700,American Medical Sciences Center,California,198625,0,0,198625,0
MA,01288100,Montachusett Regional Vocational Technical School,Massachusetts,32693,60501,105000,198194,0
FL,04238400,Florida International Training Institute,Florida,197885,0,0,197885,0
FL,04228900,Mcdougle Technical Institute,Florida,197728,0,0,197728,0
IL,01308800,Capri Oak Forest Beauty College,Illinois,197482,0,0,197482,0
WV,04234800,Randolph Technical Center,West Virginia,36561,55493,105000,197054,0
TX,04089400,Cci Training Center,Texas,196861,0,0,196861,0
KY,00197400,Louisville Presbyterian Theological Seminary,Kentucky,45392,53158,98000,196550,0
VA,02128700,Central School Of Practical Nursing,Virginia,31183,45291,120000,196474,0
CO,00135400,Iliff School Of Theology,Colorado,39110,55176,102000,196286,0
NY,04043300,Ace Institute Of Technology,New York,196165,0,0,196165,0
VA,00374300,Union Presbyterian Seminary,Virginia,41609,54003,100000,195612,0
TX,03987300,Texas Health School,Texas,195533,0,0,195533,0
NY,00818900,Continental School Of Beauty Culture,New York,195501,0,0,195501,0
TX,04154800,Duvall'S School Of Cosmetology,Texas,195388,0,0,195388,0
PA,02289700,Jolie Health And Beauty Academy,Pennsylvania,195046,0,0,195046,0
MI,04184700,Protege Academy,Michigan,194895,0,0,194895,0
IN,02607000,Tricoci University Of Beauty Culture,Indiana,194660,0,0,194660,0
LA,03030900,Diesel Driving Academy,Louisiana,194253,0,0,194253,0
OH,04068300,Four County Career Center,Ohio,18106,61957,114000,194063,0
WA,04260200,"Elite Cosmetology, Barber & Spa Academy",Washington,193873,0,0,193873,0
FL,02287100,La Belle Beauty School,Florida,193530,0,0,193530,0
NY,00738700,Long Island Beauty School,New York,192494,0,0,192494,0
KS,02606300,Paul Mitchell The School Wichita,Kansas,191805,0,0,191805,0
CO,04173800,Salon Professional Academy (The),Colorado,191082,0,0,191082,0
OR,03074500,East West College Of The Healing Arts,Oregon,191055,0,0,191055,0
MI,04230200,Paul Mitchell The School Farmington Hills,Michigan,190962,0,0,190962,0
CT,02565000,Platt Technical High School,Connecticut,32573,49006,109000,190579,0
FL,03125600,Miami Ad School,Florida,190523,0,0,190523,0
LA,04217000,Healthcare Training Institute,Louisiana,190122,0,0,190122,0
LA,02358600,Stage One-The Hair School,Louisiana,189917,0,0,189917,0
CA,04114500,Valley College Of Medical Careers,California,189724,0,0,189724,0
PR,03414300,Monteclaro: Escuela De Hoteleria Y Artes Culinarias,Puerto Rico,36831,55884,97000,189715,0
NJ,00907800,Capri Institute Of Hair Design,New Jersey,189299,0,0,189299,0
FL,04126900,Academy Of Career Training,Florida,189286,0,0,189286,0
WV,00757800,Huntington School Of Beauty Culture,West Virginia,189254,0,0,189254,0
CA,02211000,Salon Success Academy,California,189064,0,0,189064,0
NY,04234300,Culinary Tech Center,New York,188968,0,0,188968,0
CA,04145600,International College Of Cosmetology,California,188961,0,0,188961,0
LA,02518300,Lasalle Tech,Louisiana,188850,0,0,188850,0
TX,04165800,Salon Professional Academy (The),Texas,188637,0,0,188637,0
IN,02339600,Rogers Academy Of Hair Design,Indiana,188446,0,0,188446,0
MT,04187700,Crevier'S School Of Cosmetology,Montana,188300,0,0,188300,0
IN,04166700,Summit Salon Academy,Indiana,187777,0,0,187777,0
CA,02304300,Platt College - San Diego,California,187377,0,0,187377,0
CA,01294200,Rosemead Beauty School,California,187022,0,0,187022,0
MD,02331000,Maryland Beauty Academy Of Essex,Maryland,186678,0,0,186678,0
CA,04208100,Ukiah Adult School,California,49598,49975,87000,186573,0
AL,02199700,Heritage Christian University,Alabama,25804,58456,102000,186260,0
CO,01157200,Colorado School Of Trades,Colorado,186092,0,0,186092,0
NY,04264500,Yeshiva Ohr Naftoli,New York,38357,53706,94000,186063,0
NY,03903400,American Beauty School,New York,186006,0,0,186006,0
WA,04170100,Summit Salon Academy,Washington,185557,0,0,185557,0
IA,00189700,Wartburg Theological Seminary,Iowa,34289,53189,98000,185478,0
CA,04270000,Urban Barber College,California,185408,0,0,185408,0
TX,04036300,Southeast Texas Career Institute,Texas,185252,0,0,185252,0
MI,04207000,School Of Missionary Aviation Technology,Michigan,32257,53894,99000,185151,0
DC,02132800,National Conservatory Of Dramatic Arts,District of Columbia,40522,52603,92000,185125,0
NY,04178700,Atelier Esthetique Institute Of Esthetics,New York,184855,0,0,184855,0
TX,02306700,Fort Worth Beauty School,Texas,184574,0,0,184574,0
MA,04153200,Southern Worcester County Regional Voc School District,Massachusetts,43105,51330,90000,184435,0
ND,01040600,"Josef'S School Of Hair, Skin & Body",North Dakota,184384,0,0,184384,0
NY,02125500,Circle In The Square Theatre School,New York,41430,51823,91000,184253,0
ID,00987300,Aveda Institute Twin Falls,Idaho,184189,0,0,184189,0
CA,04141700,Healing Hands School Of Holistic Health,California,183798,0,0,183798,0
IL,01181000,Taylor Business Institute,Illinois,183531,0,0,183531,0
TN,03513500,Williamson Christian College,Tennessee,32878,54341,96000,183219,0
NV,03787300,Expertise Cosmetology Institute,Nevada,183021,0,0,183021,0
CA,02276800,Westminster Theological Seminary In California,California,35790,51530,95000,182320,0
UT,01116600,Broadview University,Utah,182258,0,0,182258,0
NY,02600100,New York Academy Of Art (The),New York,39863,50025,92000,181888,0
IN,04250000,Union Bible College,Indiana,34343,53329,94000,181672,0
AZ,04059300,Tucson College Of Beauty,Arizona,180991,0,0,180991,0
FL,00822300,St. Vincent De Paul Regional Seminary,Florida,40445,49286,91000,180731,0
TX,04224100,Cosmetology Academy Of Texarkana,Texas,180042,0,0,180042,0
WV,03102100,Morgantown Beauty College,West Virginia,179773,0,0,179773,0
OH,00307500,Methodist Theological School In Ohio,Ohio,37536,50007,92000,179543,0
IL,03128500,National Latino Education Institute,Illinois,40882,50379,88000,179261,0
MD,02494700,Baltimore Studio Of Hair Design,Maryland,179166,0,0,179166,0
MA,00989900,Lowell Academy Hair Styling Institute,Massachusetts,178641,0,0,178641,0
TX,00354400,Austin Presbyterian Theological Seminary,Texas,34917,50503,93000,178420,127642000
MI,04158400,L'Esprit Academy,Michigan,178333,0,0,178333,0
MI,00224800,Cranbrook Academy Of Art,Michigan,41027,48193,89000,178220,0
NJ,04131200,Total Image Beauty Academy,New Jersey,178161,0,0,178161,0
OH,04189100,Salon Institute - Toledo Campus,Ohio,177967,0,0,177967,0
IL,04175000,Universal Spa Training Academy,Illinois,177669,0,0,177669,0
NY,00290000,Webb Institute,New York,41119,48367,88000,177486,66556000
TN,04142000,Austin'S Beauty College,Tennessee,177047,0,0,177047,0
OH,02560000,Casal Aveda Institute,Ohio,176993,0,0,176993,0
VA,03042800,"School Board - City Of Va. Beach, Va. Beach School Of Prctl. Nrsg.",Virginia,28074,53783,95000,176857,0
FL,02499000,Academy Of Cosmetology,Florida,176007,0,0,176007,0
OH,01028000,Ohio State Beauty Academy,Ohio,175286,0,0,175286,0
FL,02612700,"Salon Professional Academy - Melbourne, The",Florida,175281,0,0,175281,0
FL,04250500,National Personal Training Institute,Florida,175113,0,0,175113,0
LA,01287900,Pat Goins Benton Road Beauty School,Louisiana,175113,0,0,175113,0
MD,02269700,Aveda Institute Maryland,Maryland,174174,0,0,174174,0
PA,01096300,Greene County Career & Technology Center,Pennsylvania,29535,52623,92000,174158,0
FL,04157100,L3 Commercial Training Solutions Airline Academy,Florida,173310,0,0,173310,0
CA,03874300,Cambridge Junior College,California,172968,0,0,172968,0
PA,02212700,Lancaster School Of Cosmetology & Therapeutic Bodywork,Pennsylvania,172624,0,0,172624,0
PA,00777900,Lansdale School Of Business,Pennsylvania,172490,0,0,172490,0
NY,03839300,Aveda Institute New York,New York,172354,0,0,172354,0
FL,03099600,"Mercy Hospital School Of Practical Nursing, A Program Of Plantation Ge",Florida,172183,0,0,172183,0
AR,04183400,Salon Professional Academy (The),Arkansas,172010,0,0,172010,0
OK,04060300,American Institute Of Medical Technology,Oklahoma,171804,0,0,171804,0
SC,04096300,Charleston School Of Law,South Carolina,171674,0,0,171674,0
UT,04072300,Aveda Institute Provo,Utah,171492,0,0,171492,0
CA,04190800,Santa Ana Beauty College,California,171120,0,0,171120,0
NC,02205000,College Of Wilmington,North Carolina,170909,0,0,170909,0
PR,04176000,American Technical Institute,Puerto Rico,170856,0,0,170856,0
SD,02137100,Black Hills Beauty College,South Dakota,170310,0,0,170310,0
IN,00178900,Christian Theological Seminary,Indiana,31256,48815,90000,170071,0
IN,04274300,Caris College,Indiana,169712,0,0,169712,0
MI,04183300,Abcott Institute,Michigan,169653,0,0,169653,0
PR,02588600,Seminario Evangelico De Puerto Rico,Puerto Rico,29679,48961,91000,169640,0
IA,00826000,Iowa School Of Beauty,Iowa,169529,0,0,169529,0
MA,02181600,Rob Roy Academy,Massachusetts,168757,0,0,168757,0
CA,03910400,National Polytechnic College,California,168452,0,0,168452,0
NY,04270400,Transitions Career Institute School Of Nursing,New York,167929,0,0,167929,0
PA,01321400,Roxborough Memorial Hospital,Pennsylvania,167758,0,0,167758,0
CA,04001300,Palace Beauty College,California,167681,0,0,167681,0
WA,02184200,Paroba College Of Cosmetology,Washington,167414,0,0,167414,0
AZ,03445300,Hds Truck Driving Institute,Arizona,167052,0,0,167052,0
MA,00215700,Hebrew College,Massachusetts,32876,47086,87000,166962,0
CA,02282300,Alhambra Beauty College,California,166902,0,0,166902,0
MI,04121100,Elevate Salon Institute,Michigan,166435,0,0,166435,0
CA,04235500,Presidio Graduate School,California,38408,44860,83000,166268,0
CA,03974500,California Career College,California,166258,0,0,166258,0
CA,01324000,Lytle'S Redwood Empire Beauty College,California,166160,0,0,166160,0
CA,02359300,Shasta Bible College And Graduate School,California,26199,50945,89000,166144,0
PA,02299300,Trinity Episcopal School For Ministry,Pennsylvania,27473,48571,90000,166044,0
ID,04203500,Austin Kade Academy,Idaho,165658,0,0,165658,0
IL,01083600,Pivot Point Academy,Illinois,165647,0,0,165647,0
IL,04254000,Phipps Academy Of Barbering,Illinois,165608,0,0,165608,0
DE,04171100,Paul Mitchell The School - Delaware,Delaware,165470,0,0,165470,0
NY,04151200,Salon Professional Academy (The),New York,165215,0,0,165215,0
FL,04210800,Nri Institute Of Health Sciences,Florida,163872,0,0,163872,0
HI,02139500,Hawaii Institute Of Hair Design,Hawaii,163841,0,0,163841,0
AZ,04233100,Arizona School Of Integrative Studies,Arizona,163548,0,0,163548,0
IN,04205500,Lil Lou'S Beauty And Barber College Llc,Indiana,163493,0,0,163493,0
AR,00792100,Paul Mitchell The School Arkansas,Arkansas,163392,0,0,163392,0
CA,04185600,Medical Allied Career Center,California,163365,0,0,163365,0
TX,02331200,Baptist Missionary Association Theological Seminary,Texas,20831,51368,91000,163199,0
IL,04124700,Ambria College Of Nursing,Illinois,162885,0,0,162885,0
CA,04186900,"International College Of Beauty, Arts & Sciences",California,162618,0,0,162618,0
TN,00350700,Memphis College Of Art,Tennessee,162346,0,0,162346,0
CA,04273300,Victory Career College,California,162289,0,0,162289,0
TX,04158500,Texas Beauty College,Texas,162091,0,0,162091,0
NJ,04192400,Yeshiva Gedolah Zichron Leyma,New Jersey,31665,47403,83000,162068,0
NJ,04216000,Universal Training Institute,New Jersey,162039,0,0,162039,0
TX,04138500,Houston International College Cardiotech Ultrasound School,Texas,161545,0,0,161545,0
MN,04157600,Nova Academy Of Cosmetology,Minnesota,160801,0,0,160801,0
AL,04187200,New Beginning College Of Cosmetology,Alabama,160764,0,0,160764,0
NC,03663300,Hood Theological Seminary,North Carolina,31336,45372,84000,160708,0
CA,04250600,California Institute Of Advanced Management,California,15039,50997,94000,160036,0
NJ,00642900,Saint Francis Medical Center,New Jersey,23963,48506,87000,159469,0
AR,02569600,Searcy Beauty College,Arkansas,159333,0,0,159333,0
MO,02313000,Cass Career Center,Missouri,37739,44056,77000,158795,0
CA,04245500,Universal Healthcare Careers College,California,158672,0,0,158672,0
WV,01235900,B M Spurr School Of Practical Nursing,West Virginia,31232,46255,81000,158487,0
PA,00656000,Ohio Valley General Hospital School Of Nursing,Pennsylvania,21308,49080,88000,158388,0
LA,02260200,Diesel Driving Academy,Louisiana,158043,0,0,158043,0
MO,00247600,Kenrick - Glennon Seminary,Missouri,29970,45065,83000,158035,0
CA,04159600,Galaxy Medical College,California,157375,0,0,157375,0
MO,00246200,Eden Theological Seminary,Missouri,31134,44241,82000,157375,0
MI,02324500,Michigan College Of Beauty-Monroe,Michigan,157293,0,0,157293,0
NY,03097800,Carsten Institute Of Cosmetology,New York,157005,0,0,157005,0
CA,04237800,California Barber And Beauty College,California,156711,0,0,156711,0
UT,04192700,Barber School (The) By Tim Hite,Utah,156033,0,0,156033,0
CA,04195200,Diamond Beauty College,California,155896,0,0,155896,0
AZ,04237700,Regional Center For Border Health,Arizona,13967,49729,92000,155696,0
VA,04179900,Tomorrow'S Image Barber & Beauty Academy Of Virginia,Virginia,155646,0,0,155646,0
MO,04170600,Salon Professional Academy (The),Missouri,155262,0,0,155262,0
UT,04169900,American Beauty Academy,Utah,155076,0,0,155076,0
CA,04212000,Lawrence & Company College Of Cosmetology,California,154888,0,0,154888,0
OH,03475400,Tri-State Bible College,Ohio,25800,46738,82000,154538,0
NJ,02528200,Robert Fiance Beauty Schools,New Jersey,154526,0,0,154526,0
GA,02520000,International School Of Skin And Nailcare,Georgia,154203,0,0,154203,0
MO,04218400,City Pointe Beauty Academy,Missouri,153715,0,0,153715,0
CA,00718700,North Adrian'S College Of Beauty,California,153436,0,0,153436,0
MI,04230500,Paul Mitchell The School Grand Rapids,Michigan,153424,0,0,153424,0
FL,03012300,Asm Beauty World Academy,Florida,153271,0,0,153271,0
CA,03327400,"Acupuncture And Integrative Medicine College, Berkeley",California,31425,42818,79000,153243,0
MT,04164100,Montana Academy Of Salons,Montana,152333,0,0,152333,0
IL,02262100,Hair Professionals School Of Cosmetology,Illinois,152298,0,0,152298,0
DC,01280300,Dominican House Of Studies,District of Columbia,30552,42675,79000,152227,0
WI,04157700,Salon Professional Academy (The),Wisconsin,152081,0,0,152081,0
VA,04276300,American Massage & Bodywork Institute,Virginia,151958,0,0,151958,0
WV,02178200,Charleston School Of Beauty Culture,West Virginia,151472,0,0,151472,0
AR,02538500,Arthur'S Beauty College,Arkansas,151409,0,0,151409,0
MT,03763400,Bold Beauty Academy,Montana,151384,0,0,151384,0
LA,02582200,"Guy'S Academy Hair, Skin & Nails",Louisiana,151266,0,0,151266,0
OK,02256200,Broken Arrow Beauty College,Oklahoma,150425,0,0,150425,0
TX,04178300,Vogue College Of Cosmetology,Texas,150129,0,0,150129,0
MA,03205400,Jolie Hair And Beauty Academy,Massachusetts,150088,0,0,150088,0
TX,04169100,Diamonds Cosmetology College,Texas,149983,0,0,149983,0
TX,04239700,Vocational Nursing Institute (The),Texas,17734,48103,84000,149837,0
OH,01313200,International College Of Broadcasting,Ohio,149705,0,0,149705,0
CA,02298000,Design Institute Of San Diego,California,149639,0,0,149639,0
FL,04120400,Paul Mitchell The School Miami,Florida,149326,0,0,149326,0
WI,04183600,Salon Professional Academy Of Kenosha (The),Wisconsin,149246,0,0,149246,0
NH,02179600,Empire Beauty Schools,New Hampshire,149165,0,0,149165,0
NY,00737500,Island Drafting & Technical Institute,New York,149013,0,0,149013,0
PA,02554500,Hazleton Area Career Center,Pennsylvania,33666,42190,73000,148856,0
TX,04169000,Salon & Spa Institute,Texas,148644,0,0,148644,0
UT,04153000,Renaissance Academie,Utah,148303,0,0,148303,0
GA,02321400,Toni & Guy Hairdressing Academy,Georgia,147974,0,0,147974,0
CA,02178700,Citrus Heights Beauty College,California,147682,0,0,147682,0
IL,00173600,Northern Baptist Theological Seminary,Illinois,16994,45653,84000,146647,0
GA,04150900,Keune Academy By 124,Georgia,146504,0,0,146504,0
WA,04127200,Victoria'S Academy Of Cosmetology,Washington,146462,0,0,146462,0
FL,04270800,Suncoast Technical Education Center,Florida,17940,46513,82000,146453,0
CA,03479300,Pci College,California,146325,0,0,146325,0
MA,03194300,Boston Graduate School Of Psychoanalysis,Massachusetts,25606,42390,78000,145996,0
MA,04128000,Millennium Training Institute,Massachusetts,145817,0,0,145817,0
IL,04189200,Salon Professional Academy (The),Illinois,145367,0,0,145367,0
CA,00714200,Lyle'S College Of Beauty,California,145271,0,0,145271,0
NJ,02525900,Artistic Academy Of Hair Design (The),New Jersey,144984,0,0,144984,0
FL,04116400,Future-Tech Institute,Florida,144916,0,0,144916,0
WI,04182100,First Class Cosmetology School,Wisconsin,144868,0,0,144868,0
LA,04260500,Digital Media Institute At Intertech,Louisiana,19224,45578,80000,144802,0
NY,02275900,Modern Welding School,New York,143813,0,0,143813,0
NY,04223100,Arrojo Cosmetology School,New York,143683,0,0,143683,0
WA,02541900,Bj'S Beauty & Barber College,Washington,143520,0,0,143520,0
TN,04246300,Edumed Partners,Tennessee,143284,0,0,143284,0
WV,03734300,John D. Rockefeller Iv Career Center,West Virginia,15141,46804,81000,142945,0
CO,02165200,Salon Professional Academy (The),Colorado,142706,0,0,142706,0
NY,04210700,New York Institute Of Beauty,New York,142667,0,0,142667,0
OH,04205100,Great Lakes Truck Driving School,Ohio,142439,0,0,142439,0
VA,04220400,Chrysm Institute Of Esthetics (The),Virginia,142024,0,0,142024,0
GA,04221100,New Horizons Medical Institute,Georgia,141871,0,0,141871,0
NJ,04218200,Paul Mitchell The School - Jersey Shore,New Jersey,141637,0,0,141637,0
TX,00356600,Episcopal Theological Seminary Of The Southwest (The),Texas,29097,39401,73000,141498,0
CT,04230900,Ricci'S Toni & Guy Hairdressing Academy/ Tigi Creative School,Connecticut,141397,0,0,141397,0
MI,00233100,Western Theological Seminary,Michigan,24397,40937,76000,141334,0
WI,02078000,Sacred Heart Seminary And School Of Theology,Wisconsin,28515,39714,73000,141229,0
FL,01016100,Loraines Academy & Spa,Florida,141007,0,0,141007,0
PA,00326300,Evangelical Theological Seminary,Pennsylvania,20659,42286,78000,140945,0
MS,03263300,Traxler'S School Of Hair,Mississippi,140747,0,0,140747,0
FL,04163100,Summit Salon Academy - Gainesville,Florida,140570,0,0,140570,0
CA,01044100,Pardee Rand Graduate School,California,29679,38823,72000,140502,0
OH,01289600,"North Coast College, The",Ohio,140180,0,0,140180,0
CO,04172500,Rolf Institute Of Structural Integration (The),Colorado,23419,40573,76000,139992,0
TX,04231200,Neecee'S Barber College,Texas,139821,0,0,139821,0
NM,03430300,Universal Therapeutic Massage Institute,New Mexico,139681,0,0,139681,0
NY,04225500,Westchester School For Dental Assistants,New York,139681,0,0,139681,0
TN,04215200,Vibe Barber College,Tennessee,139552,0,0,139552,0
FL,04216900,San Ignacio University,Florida,139442,0,0,139442,0
PA,04252300,Premier Barber Institute,Pennsylvania,139299,0,0,139299,0
CA,04195500,Southern States University,California,139085,0,0,139085,0
IL,04141000,Douglas J Aveda Institute-Chicago,Illinois,138888,0,0,138888,0
WA,02602100,Northwest College Of Art & Design,Washington,138482,0,0,138482,0
FL,04225000,Parisian Spa Institute,Florida,138096,0,0,138096,0
OH,01001700,Payne Theological Seminary,Ohio,25666,39396,73000,138062,0
FL,03823300,Florida Academy Of Health & Beauty,Florida,137965,0,0,137965,0
AR,04220000,Designer Barber & Stylist School,Arkansas,137801,0,0,137801,0
VA,01274400,Southside College Of Health Sciences,Virginia,137088,0,0,137088,0
IL,04224400,Networks Barber College,Illinois,136724,0,0,136724,0
TX,03011800,Ucas University Of Cosmetology Arts & Sciences,Texas,136263,0,0,136263,0
IL,04174900,Estelle International,Illinois,136220,0,0,136220,0
MO,04130600,Healing Arts Center,Missouri,136151,0,0,136151,0
VA,04153800,Bethel College,Virginia,19542,42577,74000,136119,0
TX,03970300,Hands On Therapy,Texas,135777,0,0,135777,0
FL,04148500,Medical Institute Of Palm Beach,Florida,135341,0,0,135341,0
VT,00369000,Marlboro College,Vermont,135285,0,0,135285,0
OR,04266300,Johnny Matthew'S Hairdressing Training School,Oregon,135109,0,0,135109,0
LA,02265600,John Jay Beauty College,Louisiana,135023,0,0,135023,0
NJ,04243300,Garden State Science And Technology Institute,New Jersey,134873,0,0,134873,0
ND,04031300,Salon Professional Academy (The),North Dakota,134350,0,0,134350,0
IL,00172300,Meadville Theological School Of Lombard College,Illinois,26188,38060,70000,134248,0
CA,04206800,Advance Beauty Techs Academy,California,134174,0,0,134174,0
CT,03094800,Industrial Management & Training Institute,Connecticut,133714,0,0,133714,0
MO,00163200,Aquinas Institute Of Theology,Missouri,19160,39833,74000,132993,0
CA,04222200,Fab School (The),California,132973,0,0,132973,0
CO,03027400,Avalon School Of Cosmetology,Colorado,132880,0,0,132880,0
PA,02330600,Pennsylvania Gunsmith School,Pennsylvania,132479,0,0,132479,0
PA,04158000,Metro Beauty Academy,Pennsylvania,132460,0,0,132460,0
NH,02174800,Michael'S School Of Hair Design & Esthetics Paul Mitchell Partner Scho,New Hampshire,132378,0,0,132378,0
CA,04221700,Zms The Academy,California,132113,0,0,132113,0
IA,00761100,Eq School Of Hair Design,Iowa,132044,0,0,132044,0
TN,04210200,Mid-South Christian College,Tennessee,24705,38967,68000,131672,0
CT,02245300,Howell Cheney Technical High School,Connecticut,31645,35706,64000,131351,0
UT,03617300,Healing Mountain Massage School,Utah,131175,0,0,131175,0
FL,04220200,More Tech Institute,Florida,130953,0,0,130953,0
CA,04158900,Flair Beauty College,California,130763,0,0,130763,0
CA,03577300,Coba Academy,California,130645,0,0,130645,0
WA,02202200,Stylemasters College Of Hair Design,Washington,130349,0,0,130349,0
NY,04234200,Center For Ultrasound Research & Education,New York,129533,0,0,129533,0
NY,04243200,Central Yeshiva Beth Joseph,New York,32027,35423,62000,129450,0
CO,04184900,College Of International Esthetics,Colorado,129153,0,0,129153,0
TX,02320200,Houston Graduate School Of Theology,Texas,21241,37777,70000,129018,0
IL,00171200,Lutheran School Of Theology At Chicago,Illinois,22405,37553,69000,128958,0
ID,02559500,Salon Professional Academy (The),Idaho,128759,0,0,128759,0
LA,02548500,Cosmetology Training Center,Louisiana,128629,0,0,128629,0
PR,03469300,Ivaem College,Puerto Rico,127721,0,0,127721,0
TX,03680300,Jay'S Technical Institute,Texas,126939,0,0,126939,0
FL,02508900,Talmudic College Of Florida,Florida,27499,36194,63000,126693,0
NC,02056500,Mitchell'S Academy,North Carolina,125900,0,0,125900,0
OR,01300800,Summit Salon Academy - Portland,Oregon,125842,0,0,125842,0
CA,03646300,Design'S School Of Cosmetology,California,125204,0,0,125204,0
TX,04275600,G.A. Beauty & Barber School,Texas,124879,0,0,124879,0
MO,04174000,Skin Institute,Missouri,124835,0,0,124835,0
ID,04203200,Boise Barber College A D.Martin Academy,Idaho,124720,0,0,124720,0
NJ,00261900,New Brunswick Theological Seminary,New Jersey,24151,35388,65000,124539,0
OH,03776400,Orion Institute,Ohio,124387,0,0,124387,0
IL,04224500,Trenz Beauty Academy,Illinois,124177,0,0,124177,0
NY,04207400,Yeshiva Gedola Ohr Yisrael,New York,23803,36063,64000,123866,0
IA,00794100,Salon Professional Academy (The),Iowa,123699,0,0,123699,0
NJ,01062900,Pb Cosmetology Education Centre,New Jersey,122908,0,0,122908,0
CA,04255300,Hoss Lee Academy,California,122657,0,0,122657,0
CA,04189800,Academy For Salon Professionals,California,122587,0,0,122587,0
GA,03173300,Atlanta'S John Marshall Law School,Georgia,122500,0,0,122500,0
TX,04238200,Laredo Chi Academy Beauty School,Texas,122419,0,0,122419,0
OR,02106100,College Of Cosmetology,Oregon,122071,0,0,122071,0
FL,04151500,American Academy Of Cosmetology,Florida,122040,0,0,122040,0
IN,04186600,Summit Salon Academy Kokomo,Indiana,121654,0,0,121654,0
MD,04204000,Aspen Beauty Academy - Laurel,Maryland,121302,0,0,121302,0
SC,04273900,Southeastern Esthetics Institute,South Carolina,121278,0,0,121278,0
SC,04255600,International Diving Institute,South Carolina,121044,0,0,121044,0
WA,04149400,Gary Manuel Aveda Institute,Washington,121011,0,0,121011,0
OK,02560200,Phillips Theological Seminary,Oklahoma,14422,37560,69000,120982,0
CA,02099200,American Conservatory Theater Foundation,California,25315,33386,62000,120701,0
IA,00765900,La' James College Of Hairstyling,Iowa,120456,0,0,120456,0
MS,02235900,Academy Of Hair Design #4,Mississippi,120390,0,0,120390,0
CA,03131300,Five Branches University,California,120172,0,0,120172,0
OH,02328500,Moler - Pickens Beauty College,Ohio,119658,0,0,119658,0
IN,04230300,Paul Mitchell The School Merrillville,Indiana,119533,0,0,119533,0
IL,00178300,Worsham College Of Mortuary Science,Illinois,119293,0,0,119293,0
OR,03668300,Birthingway College Of Midwifery,Oregon,18505,36531,64000,119036,0
OH,00953100,Spa School (The),Ohio,118984,0,0,118984,0
CA,03759300,Stellar Career College,California,118426,0,0,118426,0
PA,03103300,Jna Institute Of Culinary Arts,Pennsylvania,118411,0,0,118411,0
NJ,03324300,Central Career School,New Jersey,118376,0,0,118376,0
WI,04202800,Panache Academy Of Beauty,Wisconsin,118221,0,0,118221,0
NJ,04184500,Christine Valmy International School Of Esthetics & Cosmetology,New Jersey,118012,0,0,118012,0
MO,00826900,Hillyard Technical Center,Missouri,117910,0,0,117910,0
NY,02616600,Shear Ego International School Of Hair Design,New York,117714,0,0,117714,0
OH,02519300,Ohio State School Of Cosmetology,Ohio,117582,0,0,117582,0
FL,04133500,Academy For Five Element Acupuncture,Florida,21823,33364,62000,117187,0
TX,04265400,Ann Webb Skin Institute,Texas,117072,0,0,117072,0
LA,04226000,Bos-Man'S Barber College,Louisiana,117057,0,0,117057,0
OK,04224700,Jb'S Hair Design And Barber College,Oklahoma,116861,0,0,116861,0
NE,04240800,Summit Christian College,Nebraska,19025,35739,62000,116764,0
IL,04229900,Debutantes School Of Cosmetology And Nail Technology,Illinois,116746,0,0,116746,0
CA,00408000,Starr King School For The Ministry,California,23860,32584,60000,116444,0
PA,00328600,Lancaster Theological Seminary Of The United Church Of Christ,Pennsylvania,19204,34212,63000,116416,0
PA,02544300,Butler Beauty Academy,Pennsylvania,116401,0,0,116401,0
OH,04206700,Elite Welding Academy,Ohio,115917,0,0,115917,0
NJ,03536300,Institute For Therapeutic Massage,New Jersey,115588,0,0,115588,0
IL,02192400,"Mr. John'S School Of Cosmetology, Esthetics & Nails",Illinois,115442,0,0,115442,0
PA,00895500,Salon Professional Academy (The),Pennsylvania,114999,0,0,114999,0
CA,04148200,Beyond 21St Century Beauty Academy,California,114734,0,0,114734,0
NY,04119600,Yeshiva Of Far Rockaway Derech Ayson Rabbinical Seminary,New York,23752,32799,58000,114551,0
TN,04213800,Salon Professional Academy (The),Tennessee,114277,0,0,114277,0
CO,03306300,Rocky Mountain Montessori Teacher Training Program,Colorado,20588,33682,60000,114270,0
KY,04204800,American College Of Barbering,Kentucky,114269,0,0,114269,0
MS,04269500,Goshen School Of Cosmetology,Mississippi,114257,0,0,114257,0
IL,02536700,Bell Mar Beauty College,Illinois,113974,0,0,113974,0
MD,03027200,Blades School Of Hair Design,Maryland,113715,0,0,113715,0
NY,00283300,Saint Vladimirs Orthodox Theological Seminary,New York,24442,31141,58000,113583,0
IA,00626700,Unitypoint Health-Des Moines,Iowa,21716,28762,63000,113478,0
NY,03773300,Center For Natural Wellness School Of Massage Therapy,New York,113394,0,0,113394,0
IL,03684300,Northshore University Healthsystem School Of Nurse Anesthesia,Illinois,23860,31511,58000,113371,0
TX,04229000,Barber Institute Of Texas,Texas,113248,0,0,113248,0
GA,02285500,Creative Circus (The),Georgia,113193,0,0,113193,0
OR,02337900,College Of Hair Design Careers,Oregon,112927,0,0,112927,0
CA,04161700,Shasta School Of Cosmetology,California,112740,0,0,112740,0
IL,03002000,Hairmasters Institute Of Cosmetology,Illinois,112704,0,0,112704,0
IL,00166100,Chicago Theological Seminary,Illinois,17058,33605,62000,112663,0
NY,01192100,Westchester School Of Beauty Culture,New York,112451,0,0,112451,0
MO,03070200,Central College Of Cosmetology,Missouri,112354,0,0,112354,0
TN,03088800,"Watkins College Of Art, Design & Film",Tennessee,112124,0,0,112124,0
MA,04116900,Digrigoli School Of Cosmetology,Massachusetts,111760,0,0,111760,0
MI,03005700,Detroit Business Institute - Downriver,Michigan,111552,0,0,111552,0
IL,03078400,Cameo Beauty Academy,Illinois,111227,0,0,111227,0
PA,03949300,Won Institute Of Graduate Studies,Pennsylvania,18913,32274,60000,111187,0
PA,02118000,Levittown Beauty Academy,Pennsylvania,111172,0,0,111172,0
MO,02263400,Lake Career & Technical Center,Missouri,18569,29492,63000,111061,0
CA,04189700,California Miramar University,California,110771,0,0,110771,0
CA,00125600,Pacific School Of Religion,California,24442,30153,56000,110595,0
NJ,02183600,Capri Institute Of Hair Design,New Jersey,110520,0,0,110520,0
CA,02494800,Cr'U Institute Of Cosmetology And Barbering,California,110487,0,0,110487,0
VA,02358500,Bon Secours St Mary'S Hospital School Of Medical Imaging,Virginia,22589,31687,56000,110276,0
PA,04127500,Cde Career Institute,Pennsylvania,110238,0,0,110238,0
FL,04135000,Cozmo Beauty School,Florida,110109,0,0,110109,0
OH,03100100,Paramount Beauty Academy,Ohio,109818,0,0,109818,0
CT,00138700,Hartford Seminary,Connecticut,17007,32702,60000,109709,47901000
TX,01293000,Charles & Sue'S School Of Hair Design,Texas,109527,0,0,109527,0
NY,04223200,Grace International Beauty School,New York,109223,0,0,109223,0
OH,01063000,Northern Institute Of Cosmetology,Ohio,108952,0,0,108952,0
SC,02338600,Charzanne Beauty College,South Carolina,108888,0,0,108888,0
MD,00744700,Del-Mar-Va Beauty Academy,Maryland,108845,0,0,108845,0
MN,00983100,Model College Of Hair Design,Minnesota,108435,0,0,108435,0
TN,04236400,Sandra Academy Of Salon Services,Tennessee,108427,0,0,108427,0
WA,04231000,Studio Beauty School,Washington,108031,0,0,108031,0
AZ,00886400,Arizona Academy Of Beauty,Arizona,107836,0,0,107836,0
KY,02551100,Pj'S College Of Cosmetology,Kentucky,107097,0,0,107097,0
IA,03441300,Iowa School Of Beauty,Iowa,106994,0,0,106994,0
NY,04180200,Long Island Nail Skin & Hair Institute,New York,106834,0,0,106834,0
TX,02326000,Ucas University Of Cosmetology Arts & Sciences,Texas,106620,0,0,106620,0
MD,03937300,Yeshiva College Of The Nation'S Capital,Maryland,19734,31640,55000,106374,0
OH,01174400,National Beauty College,Ohio,106210,0,0,106210,0
VT,00865800,O'Briens Aveda Institute,Vermont,106040,0,0,106040,0
CA,04226100,Lawrence & Company College Of Cosmetology,California,106027,0,0,106027,0
CA,04163400,Cosmo Beauty Academy,California,105841,0,0,105841,0
RI,04246000,Michael K. Galvin Beauty & Business Academy,Rhode Island,105677,0,0,105677,0
NC,04073300,Jung Tao School Of Classical Chinese Medicine,North Carolina,23569,28834,53000,105403,0
OR,01234700,Phagans' Central Oregon Beauty College,Oregon,105390,0,0,105390,0
NJ,02146800,Joe Kubert School Of Cartoon & Graphic Art (The),New Jersey,105343,0,0,105343,0
AL,03783300,Blue Cliff Career College,Alabama,105082,0,0,105082,0
OH,00953000,Gerber Akron Beauty School,Ohio,104975,0,0,104975,0
OH,04185900,Elite School Of Cosmetology,Ohio,104805,0,0,104805,0
IN,00951500,J. Michael Harrold Beauty Academy,Indiana,104382,0,0,104382,0
FL,03491400,American Advanced Technicians Institute,Florida,104373,0,0,104373,0
MI,01109800,Flint Institute Of Barbering,Michigan,104198,0,0,104198,0
TX,03009400,Nuvani Institute,Texas,104127,0,0,104127,0
CA,04272800,Independent Training & Apprenticeship Program,California,104035,0,0,104035,0
CA,04272100,Princess Institute Of Beauty,California,103999,0,0,103999,0
NC,02560600,Pinnacle Institute Of Cosmetology,North Carolina,103889,0,0,103889,0
LA,04112300,Louisiana Culinary Institute,Louisiana,103694,0,0,103694,0
MS,03032400,Kc'S School Of Hair Design,Mississippi,103552,0,0,103552,0
WA,01249600,Evergreen Beauty And Barber College,Washington,103456,0,0,103456,0
CA,04209800,Hinton Barber And Beauty College,California,103446,0,0,103446,0
NY,04156000,Academy Of Cosmetology & Esthetics Nyc (The),New York,102983,0,0,102983,0
NY,01161400,Champlain Valley Physicians Hospital Medical Center,New York,20970,29862,52000,102832,0
OH,02324400,Allstate Hairstyling & Barber College,Ohio,102790,0,0,102790,0
MO,03519300,Missouri College Of Cosmetology North,Missouri,102704,0,0,102704,0
MS,02251600,Academy Of Hair Design #6,Mississippi,102117,0,0,102117,0
TX,04245800,Natural Images Beauty College,Texas,102034,0,0,102034,0
WA,04258000,Seattle Film Institute,Washington,101834,0,0,101834,0
LA,02352500,Cloyd'S Beauty School #3,Louisiana,101047,0,0,101047,0
TN,02188300,Pentecostal Theological Seminary,Tennessee,14436,30528,56000,100964,0
LA,04245400,Infinity College,Louisiana,100915,0,0,100915,0
LA,04264800,J'S Barber College,Louisiana,100902,0,0,100902,0
OH,04166800,Summit Salon Academy,Ohio,100760,0,0,100760,0
CA,02520300,Interior Designers Institute,California,100622,0,0,100622,0
NY,03216300,Unification Theological Seminary,New York,20435,28113,52000,100548,0
CA,04014400,Palladium Technical Academy,California,100425,0,0,100425,0
OH,03116200,Dayton Barber College,Ohio,100249,0,0,100249,0
NY,03419400,Northeastern Seminary,New York,15122,29988,55000,100110,0
OH,00485500,Davis College,Ohio,99923,0,0,99923,0
CA,02167800,Estes Institute Of Cosmetology Arts & Sciences,California,99744,0,0,99744,0
WV,00895900,Clarksburg Beauty Academy & School Of Massage Therapy,West Virginia,99727,0,0,99727,0
AR,02284200,New Tyler Barber College,Arkansas,99723,0,0,99723,0
CO,04179700,United Beauty College,Colorado,99695,0,0,99695,0
PA,04224600,Barber School Of Pittsburgh,Pennsylvania,99473,0,0,99473,0
MN,00238600,United Theological Seminary Of The Twin Cities,Minnesota,17458,28920,53000,99378,0
OK,03453400,Shawnee Beauty College,Oklahoma,99268,0,0,99268,0
TX,04249300,Salon Boutique Academy,Texas,98873,0,0,98873,0
ID,04176700,Aveda Institute Boise,Idaho,98861,0,0,98861,0
FL,03986300,Aviator College Of Aeronautical Science & Technology,Florida,98828,0,0,98828,0
CA,04277700,California College Of Barbering And Cosmetology,California,98672,0,0,98672,0
TN,04246100,Nashville Film Institute,Tennessee,98653,0,0,98653,0
CA,04262100,My Beauty & Barber College,California,98476,0,0,98476,0
MA,04193100,Alexander Academy,Massachusetts,98351,0,0,98351,0
LA,02269300,Stevenson Academy Of Hair Design,Louisiana,98324,0,0,98324,0
OR,02154400,Beau Monde Academy Of Cosmetology,Oregon,98322,0,0,98322,0
VT,02254000,New England Culinary Institute,Vermont,98063,0,0,98063,0
ID,03832400,Cosmetology School Of Arts And Sciences,Idaho,97960,0,0,97960,0
NJ,02154000,Divers Academy Of The Eastern Seaboard,New Jersey,97783,0,0,97783,0
WV,01257300,West Virginia University Hospitals,West Virginia,20244,27492,50000,97736,0
KS,00250900,Saint Paul School Of Theology,Kansas,20672,27032,50000,97704,0
CO,04195300,Elevate Salon Institute,Colorado,97669,0,0,97669,0
LA,01288000,Celebrity Stylist Beauty School,Louisiana,97628,0,0,97628,0
TX,04125500,Manuel & Theresa'S School Of Hair Design,Texas,97462,0,0,97462,0
FL,02517100,Sarasota School Of Massage Therapy,Florida,97165,0,0,97165,0
LA,02619200,Denham Springs Beauty College,Louisiana,97153,0,0,97153,0
MO,00959000,Summit Salon Academy Kansas City,Missouri,97014,0,0,97014,0
CA,02236400,"Thanh Le College, School Of Cosmetology",California,96857,0,0,96857,0
MS,02302800,Mississippi College Of Beauty Culture,Mississippi,96624,0,0,96624,0
FL,03374300,Florida Coastal School Of Law,Florida,96603,0,0,96603,0
LA,01163100,D'Jay'S Institute Of Cosmetology And Esthiology,Louisiana,96315,0,0,96315,0
KS,04205300,Mitsu Sato Hair Academy,Kansas,96274,0,0,96274,0
CA,04256400,San Bernardino Beauty College,California,96223,0,0,96223,0
TN,04124100,Elite College Of Cosmetology,Tennessee,96164,0,0,96164,0
NJ,02103700,Capri Institute Of Hair Design,New Jersey,96142,0,0,96142,0
MS,04140200,"Mississippi Institute Of Aesthetics, Nails, & Cosmetology",Mississippi,96122,0,0,96122,0
FL,04129900,Florida School Of Massage,Florida,96011,0,0,96011,0
IL,02573700,Institute For Clinical Social Work,Illinois,15713,28239,52000,95952,0
OH,02529500,Hamrick School,Ohio,95932,0,0,95932,0
UT,02078800,Collectiv Hair Dressing Academy,Utah,95923,0,0,95923,0
NY,02511500,"Joffrey Ballet School, American Ballet Center",New York,95735,0,0,95735,0
IN,04140500,Horizon University,Indiana,7486,31710,56000,95196,0
FL,04029300,Trendsetters Of Fl. School Of Beauty & Barbering,Florida,95086,0,0,95086,0
VA,04219000,Iglobal University,Virginia,95038,0,0,95038,0
IL,00947500,Educators Of Beauty College Of Cosmetology,Illinois,94989,0,0,94989,0
NJ,02265500,Capri Institute Of Hair Design,New Jersey,94976,0,0,94976,0
IL,00166300,Spertus College Of Judaica,Illinois,11595,29093,54000,94688,0
IL,02587700,Hair Professionals Career College,Illinois,94467,0,0,94467,0
KY,02159100,Appalachian Beauty School,Kentucky,94425,0,0,94425,0
CA,00884400,California Christian College,California,12359,30024,52000,94383,0
LA,04234600,Park Place Premier Barber School,Louisiana,94356,0,0,94356,0
CA,03995300,University Of East-West Medicine,California,94275,0,0,94275,0
AZ,03814300,Turning Point Beauty College,Arizona,94238,0,0,94238,0
WI,03822300,Paul Mitchell The School - Madison,Wisconsin,94232,0,0,94232,0
UT,03082100,Myotherapy College Of Utah,Utah,94214,0,0,94214,0
IL,02349500,Cannella School Of Hair Design,Illinois,93948,0,0,93948,0
WV,03052000,Meredith Manor International Equestrian Centre,West Virginia,93719,0,0,93719,0
FL,04246900,Piberry Institute,Florida,93447,0,0,93447,0
NY,03203300,New York Institute Of Massage,New York,93376,0,0,93376,0
OH,04254900,Cincinnati School Of Barbering & Hair Design,Ohio,93183,0,0,93183,0
PA,04232000,Studio Incamminati,Pennsylvania,14667,28403,50000,93070,0
UT,04165500,Acaydia Spa And School Of Aesthetics,Utah,92748,0,0,92748,0
NH,04263000,Harmony Health Care Institute,New Hampshire,91855,0,0,91855,0
NE,04132600,Paul Mitchell The School - Lincoln,Nebraska,91829,0,0,91829,0
MO,00639200,Research Medical Center,Missouri,91737,0,0,91737,0
AZ,04267500,International Barber College,Arizona,91467,0,0,91467,0
WI,00387400,Nashotah House,Wisconsin,16876,26136,48000,91012,0
IL,04232300,Hvac Technical Institute,Illinois,90904,0,0,90904,0
NE,00849200,Chi Health School Of Radiologic Technology,Nebraska,20297,23431,47000,90728,0
NY,02550600,Talmudical Institute Of Upstate New York,New York,17933,26497,46000,90430,0
OK,04144400,Academy Of Hair Design (The),Oklahoma,90375,0,0,90375,0
MO,02520800,Merrell University Of Beauty Arts & Science,Missouri,90177,0,0,90177,0
AL,04211000,Salon Professional Academy (The),Alabama,90139,0,0,90139,0
NC,04173000,Shepherds Theological Seminary,North Carolina,16125,25893,48000,90018,0
PA,02061000,Venus Beauty Academy,Pennsylvania,89682,0,0,89682,0
NY,04134000,"John Paolo'S Xtreme Beauty Institute, Goldwell Products Artistry",New York,89593,0,0,89593,0
CA,03962300,American Institute Of Massage Therapy,California,89422,0,0,89422,0
CA,04217500,J D Academy Of Salon And Spa,California,89296,0,0,89296,0
NY,00928300,Midway Paris Beauty School,New York,89208,0,0,89208,0
ID,02275800,Mr. Leon'S School Of Hair Design,Idaho,89201,0,0,89201,0
LA,02327800,Pineville Beauty School,Louisiana,89065,0,0,89065,0
NY,00738800,Long Island Beauty School,New York,88800,0,0,88800,0
CA,04181600,Integrity College Of Health,California,88763,0,0,88763,0
ID,02314000,Elevate Salon Institute,Idaho,88720,0,0,88720,0
GA,04264600,Hogan Institute Of Cosmetology And Esthetics,Georgia,88626,0,0,88626,0
FL,04251700,Hope College Of Arts And Sciences,Florida,88555,0,0,88555,0
AL,04066300,Cardiac And Vascular Institute Of Ultrasound,Alabama,88302,0,0,88302,0
AR,04270100,Delta Designs Cosmetology School,Arkansas,88170,0,0,88170,0
CA,00116500,Church Divinity School Of The Pacific,California,18783,24290,45000,88073,16243000
SC,03293300,Strand College Of Hair Design,South Carolina,87957,0,0,87957,0
TX,03922300,South Texas Barber College,Texas,87713,0,0,87713,0
PA,01292900,South Hills Beauty Academy,Pennsylvania,87671,0,0,87671,0
MN,04148800,Centerpoint Massage & Shiatsu Therapy School & Clinic,Minnesota,87374,0,0,87374,0
FL,04223400,Interamerican Technical Institute,Florida,87212,0,0,87212,0
OH,02545800,Inner State Beauty School,Ohio,87203,0,0,87203,0
CA,04255400,Regan Career Institute,California,87162,0,0,87162,0
MO,03916300,Eclips School Of Cosmetology And Barbering,Missouri,87102,0,0,87102,0
NC,04219100,Alexander Paul Institute Of Hair Design,North Carolina,86901,0,0,86901,0
OR,03185300,Phagans' Grants Pass College Of Beauty,Oregon,86854,0,0,86854,0
MA,00220200,Pope St. John Xxiii National Seminary,Massachusetts,21532,22984,42000,86516,0
IL,00959500,Cannella School Of Hair Design,Illinois,86227,0,0,86227,0
WV,00500800,Mountain State College,West Virginia,86177,0,0,86177,0
NJ,04260400,Cutting Edge Academy,New Jersey,85930,0,0,85930,0
FL,04167300,Salon Professional Academy (The),Florida,85687,0,0,85687,0
NY,02158200,Washington Saratoga Warren Hamilton Essex Boces,New York,22752,20845,42000,85597,0
MN,02050300,Academy College,Minnesota,85565,0,0,85565,0
SC,02552400,Academy Of Hair Technology,South Carolina,85165,0,0,85165,0
TN,04240700,Image Maker Beauty Institute,Tennessee,85137,0,0,85137,0
TX,02267100,Exposito School Of Hair Design,Texas,84964,0,0,84964,0
MO,02214500,Salem College Of Hairstyling,Missouri,84962,0,0,84962,0
PA,03072600,Dci Career Institute,Pennsylvania,84945,0,0,84945,0
MO,04212100,Academy Of Salon Professionals,Missouri,84787,0,0,84787,0
ME,03429300,Seacoast Career Schools,Maine,84741,0,0,84741,0
CT,04249800,Dolce Llc The Academy,Connecticut,84286,0,0,84286,0
CA,03367300,Professional Golfers Career College,California,84229,0,0,84229,0
FL,04229700,First Coast Barber Academy,Florida,83945,0,0,83945,0
TX,02362800,Austin Graduate School Of Theology,Texas,10135,26735,47000,83870,0
IL,03082900,Rosel School Of Cosmetology,Illinois,83474,0,0,83474,0
ME,04188800,Institute For Doctoral Studies In The Visual Arts,Maine,14258,24140,45000,83398,0
CA,03740400,Ati College,California,83260,0,0,83260,0
OR,01234800,Phagans' Beauty College,Oregon,83228,0,0,83228,0
LA,02536400,Louisiana Academy Of Beauty,Louisiana,83167,0,0,83167,0
UT,02573100,Evans Hairstyling College Of Cedar City,Utah,83133,0,0,83133,0
AL,04273500,Winonah'S International School Of Cosmetology,Alabama,82925,0,0,82925,0
SC,04243500,Barber Tech Academy,South Carolina,82720,0,0,82720,0
CA,02230900,Fredrick And Charles Beauty College,California,82451,0,0,82451,0
CA,02220000,Colleen O'Hara'S Beauty Academy,California,82427,0,0,82427,0
GA,04242300,Dalton Institute Of Esthetics And Cosmetology,Georgia,82217,0,0,82217,0
PA,01191900,Beaver Falls Beauty Academy,Pennsylvania,82135,0,0,82135,0
AZ,04174200,All Beauty College,Arizona,82062,0,0,82062,0
CA,02609000,Emperor'S College Of Traditional Oriental Medicine,California,82054,0,0,82054,0
VA,03872400,Divine Mercy University,Virginia,12649,24391,45000,82040,0
AR,01074100,Academy Of Salon And Spa,Arkansas,81774,0,0,81774,0
TX,04243900,University Of Texas Health Science Center At Tyler (The),Texas,9311,25459,47000,81770,0
NY,04204300,"Aesthetic Science Institute, Llc (The)",New York,81723,0,0,81723,0
AR,03007100,Hot Springs Beauty College,Arkansas,81480,0,0,81480,0
TX,04152700,Astrodome Career Centers,Texas,81224,0,0,81224,0
FL,03888300,Dragon Rises College Of Oriental Medicine,Florida,18040,21995,41000,81035,0
IA,00423300,Saint Luke'S Methodist Hospital School Of Radiologic Technology,Iowa,18551,22360,40000,80911,0
FL,04233900,Atlantis University,Florida,80885,0,0,80885,0
WI,03061200,Midwest College Of Oriental Medicine,Wisconsin,80513,0,0,80513,0
CA,00129600,Dominican School Of Philosophy And Theology,California,13676,23500,43000,80176,0
TX,01202000,Victoria Beauty College,Texas,79984,0,0,79984,0
CA,04158800,Theatre Of Arts,California,79898,0,0,79898,0
TX,02058600,Bk Cosmo College Of Cosmetology,Texas,79091,0,0,79091,0
OH,01284800,Moler Hollywood Beauty Academy,Ohio,79077,0,0,79077,0
CA,04132400,Academy Of Esthetics And Cosmetology,California,79073,0,0,79073,0
CT,00745900,Paier College Of Art,Connecticut,78906,0,0,78906,0
NH,02211600,Paul Mitchell The School Portsmouth,New Hampshire,78689,0,0,78689,0
LA,02601100,Opelousas School Of Cosmetology,Louisiana,78578,0,0,78578,0
ID,04268300,Rexburg College Of Massage Therapy,Idaho,78561,0,0,78561,0
FL,03757300,Advance Science International College,Florida,78324,0,0,78324,0
MA,03316400,Fine Mortuary College,Massachusetts,78045,0,0,78045,0
NV,04248800,Wongu University Of Oriental Medicine,Nevada,14840,21995,41000,77835,0
AL,04255500,Alabama School Of Nail Technology & Cosmetology,Alabama,77735,0,0,77735,0
VA,04267700,Esthetic Institute (The),Virginia,77722,0,0,77722,0
MI,04002400,Ecumenical Theological Seminary,Michigan,14258,22226,41000,77484,0
NY,04250200,Focus Personal Training Institute,New York,77434,0,0,77434,0
IN,02304800,Pj'S College Of Cosmetology,Indiana,77190,0,0,77190,0
MT,00790000,Butte Academy Of Beauty Culture,Montana,77189,0,0,77189,0
IN,00182300,Anabaptist Mennonite Biblical Seminary,Indiana,12438,22444,42000,76882,0
NY,00281500,Saint Bernard'S School Of Theology And Ministry,New York,13676,21958,41000,76634,0
IN,04256100,Indiana College Of Sports & Medical Massage,Indiana,76551,0,0,76551,0
CA,03054100,Royale College Of Beauty And Barbering,California,76241,0,0,76241,0
CA,01244600,Universal College Of Beauty,California,76226,0,0,76226,0
KY,02526100,Jenny Lea Academy Of Cosmetology,Kentucky,76044,0,0,76044,0
NY,04179800,Sotheby'S Institute Of Art - Ny,New York,75653,0,0,75653,0
SC,04244100,Construction Training Center,South Carolina,75525,0,0,75525,0
MI,02285700,Bayshire Beauty Academy,Michigan,75520,0,0,75520,0
TX,04168800,Abc Beauty Academy,Texas,75257,0,0,75257,0
FL,04209500,Shear Finesse Beauty Academy,Florida,75116,0,0,75116,0
UT,03829500,Skinworks School Of Advanced Skincare,Utah,74698,0,0,74698,0
MO,00249400,Nazarene Theological Seminary,Missouri,13954,21141,39000,74095,0
TX,02521800,Seguin Beauty School,Texas,74070,0,0,74070,0
NM,04178500,Vogue College Of Cosmetology,New Mexico,74042,0,0,74042,0
WI,02271300,Wisconsin School Of Professional Psychology,Wisconsin,13967,21071,39000,74038,0
AZ,02280500,Charles Of Italy Beauty College,Arizona,74036,0,0,74036,0
NY,00270000,Colgate Rochester Crozer Divinity School,New York,13094,21299,39000,73393,0
FL,02329900,Florida Institute Of Ultrasound,Florida,73059,0,0,73059,0
PR,03608300,Caribbean Forensic & Technical College,Puerto Rico,72934,0,0,72934,0
WI,03220300,"Professional Hair Design Academy, The",Wisconsin,72826,0,0,72826,0
MI,02491000,West Michigan College Of Barbering And Beauty,Michigan,72745,0,0,72745,0
CO,03584400,Colorado School Of Healing Arts,Colorado,72624,0,0,72624,0
CA,02061600,Wayne'S College Of Beauty,California,72461,0,0,72461,0
TX,04231300,Yahweh Beauty Academy,Texas,72253,0,0,72253,0
VA,04169400,Northern Virginia School Of Therapeutic Massage,Virginia,71989,0,0,71989,0
SC,04239000,B-Unique Beauty And Barber Academy,South Carolina,71620,0,0,71620,0
ID,04134300,Evans Hairstyling College,Idaho,71597,0,0,71597,0
NY,04190500,New York School Of Esthetics & Day Spa,New York,71583,0,0,71583,0
MN,04044300,Hazelden Graduate School Of Addiction Studies,Minnesota,16012,19558,36000,71570,0
MI,04055300,Creative Hair School Of Cosmetology,Michigan,71456,0,0,71456,0
CA,03786300,Advanced College,California,71329,0,0,71329,0
NV,03881400,European Massage Therapy School (The),Nevada,71306,0,0,71306,0
UT,04161900,Mandalyn Academy,Utah,71253,0,0,71253,0
KY,02518900,Barrett & Company School Of Hair Design,Kentucky,70869,0,0,70869,0
CA,04145000,San Diego Culinary Institute,California,70731,0,0,70731,0
AL,04197500,University Academy Of Hair Design,Alabama,70719,0,0,70719,0
WA,04132800,Inland Massage Institute,Washington,70663,0,0,70663,0
NY,02182200,New School Center For Media,New York,70490,0,0,70490,0
CT,04128800,Branford Academy Of Hair & Cosmetology,Connecticut,70305,0,0,70305,0
OK,02126500,Enid Beauty College,Oklahoma,70272,0,0,70272,0
NJ,04188700,Asi Career Institute,New Jersey,70108,0,0,70108,0
AL,04267900,Brown Beauty Barber School,Alabama,70098,0,0,70098,0
OH,02588500,Ohio State School Of Cosmetology,Ohio,70032,0,0,70032,0
KY,04177600,Lindsey Institute Of Cosmetology,Kentucky,69690,0,0,69690,0
NC,04101300,Carolina School Of Broadcasting,North Carolina,69411,0,0,69411,0
KY,00197100,Lexington Theological Seminary,Kentucky,7748,21480,40000,69228,0
OH,02315500,Toledo Academy Of Beauty Culture - East,Ohio,69228,0,0,69228,0
MI,02595700,Hillsdale Beauty College,Michigan,69128,0,0,69128,0
CA,04155500,Academy For Jewish Religion California,California,12221,19897,37000,69118,0
PA,00657800,Sharon Regional School Of Nursing,Pennsylvania,68940,0,0,68940,0
ND,04139400,Hair Academy (The),North Dakota,68765,0,0,68765,0
WI,04118600,Tricoci University Of Beauty Culture,Wisconsin,68585,0,0,68585,0
MI,04141100,French Academy Of Cosmetology,Michigan,68450,0,0,68450,0
VA,04238700,Dermal Science International Aesthetics & Nail Academy,Virginia,68341,0,0,68341,0
TN,02257400,Arnold'S Beauty School,Tennessee,68240,0,0,68240,0
DE,03702300,Delaware Learning Institute Of Cosmetology,Delaware,68172,0,0,68172,0
FL,03801400,Beauty Institute (The),Florida,67958,0,0,67958,0
FL,04244700,Med Academy,Florida,67956,0,0,67956,0
GA,02060900,Brown College Of Court Reporting,Georgia,67945,0,0,67945,0
LA,04225900,Setting The Standard Barbering And Natural Hair Academy,Louisiana,67932,0,0,67932,0
AR,04241800,Academy Of Professional Cosmetology,Arkansas,67844,0,0,67844,0
TN,04157200,Love Beauty School,Tennessee,67806,0,0,67806,0
SC,02356600,Charleston Cosmetology Institute,South Carolina,67783,0,0,67783,0
HI,04269600,Ibs School Of Cosmetology And Massage,Hawaii,67672,0,0,67672,0
OK,02531200,Formations Institute Of Cosmetology & Barbering Llc,Oklahoma,67651,0,0,67651,0
DC,04142700,Pontifical John Paul Ii Institute For Studies On Marriage And Family,District of Columbia,12221,19424,36000,67645,0
IL,03747300,Bexley Seabury Seminary Federation,Illinois,6110,21505,40000,67615,0
MN,00960000,"Cosmetology Careers Unlimited College Of Hair, Skin, And Nails",Minnesota,67512,0,0,67512,0
CA,02065700,California Beauty College,California,67420,0,0,67420,0
MO,04146100,Urshan Graduate School Of Theology,Missouri,10234,20077,37000,67311,0
WA,04274700,Centralia Beauty College,Washington,66750,0,0,66750,0
MD,03822400,Maple Springs Baptist Bible College & Seminary,Maryland,5620,21677,39000,66297,0
NY,04189000,Barber & Beauty Institute Of New York,New York,66110,0,0,66110,0
WI,04138200,Salon Professional Academy (The),Wisconsin,65719,0,0,65719,0
OR,04146500,Portland Actors Conservatory,Oregon,15222,17450,33000,65672,0
TX,02604700,Center For Advanced Legal Studies,Texas,65587,0,0,65587,0
SC,00492400,Forrest College,South Carolina,65558,0,0,65558,0
OK,04257700,Totally Cosmo School Of Modern Cosmetology,Oklahoma,65291,0,0,65291,0
OK,02510300,Beauty Technical College,Oklahoma,65203,0,0,65203,0
NY,02587600,Orlo School Of Hair Design & Cosmetology (The),New York,65152,0,0,65152,0
CA,04243100,Alhambra Medical University,California,65078,0,0,65078,0
NC,04228400,Beyond Measure Barbering Institute,North Carolina,65065,0,0,65065,0
IA,02262500,Faust Institute Of Cosmetology,Iowa,65010,0,0,65010,0
PA,04257900,American Barber And Beauty Academy,Pennsylvania,64928,0,0,64928,0
OK,03109800,Ponca City Beauty College,Oklahoma,64850,0,0,64850,0
MD,02495000,Robert Paul Academy Of Cosmetology Arts & Sciences,Maryland,64827,0,0,64827,0
MI,01229100,Wright Beauty Academy,Michigan,64647,0,0,64647,0
NY,03934300,Yeshiva Zichron Aryeh,New York,14059,18253,32000,64312,0
TN,03840300,Omega Graduate School,Tennessee,10184,19096,35000,64280,0
TX,04155800,Advanced Beauty College,Texas,64217,0,0,64217,0
TX,01248800,International Beauty College #3,Texas,64097,0,0,64097,0
AR,04247600,New Beginnings Beauty Academy,Arkansas,63880,0,0,63880,0
FL,03429700,East West College Of Natural Medicine,Florida,63723,0,0,63723,0
MI,01321800,M.J. Murphy Beauty College,Michigan,63536,0,0,63536,0
TX,03277300,Pathway Vocational Academy,Texas,63239,0,0,63239,0
TX,04276700,Salon Professional Academy (The),Texas,63166,0,0,63166,0
MA,02163500,New England School Of Photography,Massachusetts,62906,0,0,62906,0
IL,04189400,Shear Learning Academy Of Cosmetology,Illinois,62701,0,0,62701,0
PR,03068400,Quality Technical & Beauty College,Puerto Rico,62586,0,0,62586,0
CA,03019900,Capstone College,California,62462,0,0,62462,0
MO,00960700,House Of Heavilin Beauty College,Missouri,62404,0,0,62404,0
WI,04179200,Advanced College Of Cosmetology,Wisconsin,62265,0,0,62265,0
OK,04184300,Paul Mitchell The School Ardmore,Oklahoma,61953,0,0,61953,0
LA,02197500,Baton Rouge School Of Computers,Louisiana,61790,0,0,61790,0
NY,00282200,Christ The King Seminary,New York,11057,17714,33000,61771,0
NY,03983300,"School Of Professional Horticulture, N. Y. Botanical Garden",New York,12767,17482,31000,61249,0
FL,04214500,Prestige Health & Beauty Sciences Academy,Florida,61112,0,0,61112,0
ID,02349200,Headmasters School Of Hair Design,Idaho,61086,0,0,61086,0
NE,03164300,Creative Center (The),Nebraska,61073,0,0,61073,0
TX,04250800,Mission Beauty Institute,Texas,61068,0,0,61068,0
CA,04119200,Eagle Rock College,California,60954,0,0,60954,0
TN,02595000,Hair Academy The,Tennessee,60842,0,0,60842,0
IN,02164300,Don Roberts School Of Hair Design,Indiana,60627,0,0,60627,0
MT,04163700,Bitterroot School Of Cosmetology,Montana,60612,0,0,60612,0
TN,02278700,Mister Wayne'S School Of Unisex Hair Design,Tennessee,60570,0,0,60570,0
FL,04233400,Lee Professional Institute,Florida,60437,0,0,60437,0
OR,01012200,Phagans' Medford Beauty School,Oregon,60405,0,0,60405,0
MA,01294800,Rob Roy Academy,Massachusetts,60343,0,0,60343,0
NY,04213400,Access Careers,New York,60255,0,0,60255,0
OH,00406000,Winebrenner Theological Seminary,Ohio,12366,16856,31000,60222,0
AR,04272400,Northern Technical College,Arkansas,59671,0,0,59671,0
CA,04176300,Bergin College Of Canine Studies,California,25825,33669,0,59494,0
TX,03179500,Texas Health And Science University,Texas,59416,0,0,59416,0
CA,00720900,Redondo Beach Beauty College,California,58790,0,0,58790,0
MO,02309100,American College Of Hair Design,Missouri,58724,0,0,58724,0
MI,04006300,Nuvo College Of Cosmetology,Michigan,58614,0,0,58614,0
KY,04123900,Lexington Healing Arts Academy,Kentucky,58500,0,0,58500,0
FL,03238300,Florida College Of Integrative Medicine,Florida,58486,0,0,58486,0
LA,01109700,Cloyd'S Beauty School #1,Louisiana,58274,0,0,58274,0
SC,04192600,Palmetto Beauty School,South Carolina,58220,0,0,58220,0
CO,04271000,Stacey James Institute,Colorado,58169,0,0,58169,0
CA,03025600,Dell'Arte International School Of Physical Theatre,California,14549,15343,28000,57892,0
IA,02289000,American Hair Academy,Iowa,57867,0,0,57867,0
DC,03218300,University Of The Potomac,District of Columbia,57862,0,0,57862,0
MO,03110900,House Of Heavilin Of Blue Springs,Missouri,57775,0,0,57775,0
IL,02556600,Niles School Of Cosmetology,Illinois,57709,0,0,57709,0
MS,02249900,Delta Beauty College,Mississippi,57587,0,0,57587,0
DE,04130700,Academy Of Massage And Bodywork,Delaware,57444,0,0,57444,0
MS,02251700,Foster'S Cosmetology College,Mississippi,57219,0,0,57219,0
OK,03103800,Southern School Of Beauty,Oklahoma,57017,0,0,57017,0
NY,00272600,General Theological Seminary Of The Episcopal Church (The),New York,10475,16375,30000,56850,0
SC,04158100,Aiken School Of Cosmetology And Barbering,South Carolina,56697,0,0,56697,0
LA,03498400,Omega Institute Of Cosmetology,Louisiana,56616,0,0,56616,0
IA,02306900,Iowa School Of Beauty,Iowa,56508,0,0,56508,0
PA,02270500,Bucks County School Of Beauty Culture,Pennsylvania,55682,0,0,55682,0
FL,04269700,Ur Beauty & Barber Academy,Florida,55477,0,0,55477,0
UT,03110400,Paul Mitchell The School St. George,Utah,55312,0,0,55312,0
FL,04213200,Kaizen Beauty Academy,Florida,55217,0,0,55217,0
TX,04117900,Champion Beauty College,Texas,55136,0,0,55136,0
NM,04271600,"Avenue Academy, A Cosmetology Institute (The)",New Mexico,54745,0,0,54745,0
DE,04250300,Hair Academy School Of Barbering & Beauty,Delaware,54631,0,0,54631,0
GA,04256600,Mak Beauty Institute,Georgia,54557,0,0,54557,0
WA,04252900,International Beauty Education Center,Washington,54461,0,0,54461,0
MA,02092100,Massachusetts School Of Barbering,Massachusetts,54414,0,0,54414,0
TX,04222600,Healthcare Institute (The),Texas,54372,0,0,54372,0
PA,02290400,Altoona Beauty School,Pennsylvania,54362,0,0,54362,0
NE,03821400,Universal College Of Healing Arts,Nebraska,54312,0,0,54312,0
CA,00720400,Modern Beauty Academy - Oxnard,California,54154,0,0,54154,0
IL,02297500,Oehrlein School Of Cosmetology,Illinois,54088,0,0,54088,0
SC,03746300,Legrand Institute Of Cosmetology,South Carolina,54018,0,0,54018,0
AR,02202400,Professional Cosmetology Education Center,Arkansas,53985,0,0,53985,0
WV,02145100,Scott College Of Cosmetology,West Virginia,53972,0,0,53972,0
MN,02097300,Hastings Beauty School,Minnesota,53763,0,0,53763,0
MD,04141600,Omega Studios' School Of Applied Recording Arts & Sciences,Maryland,53482,0,0,53482,0
NY,02314200,Empire Beauty School,New York,53477,0,0,53477,0
NC,04178100,Carolina College Of Hair Design,North Carolina,53472,0,0,53472,0
VA,04038400,Avi Career Training,Virginia,53197,0,0,53197,0
MD,03667300,Faith Theological Seminary,Maryland,53194,0,0,53194,0
CA,03163300,Pacific States University,California,13385,13801,26000,53186,0
CO,03976300,Massage Therapy Institute Of Colorado,Colorado,53176,0,0,53176,0
CA,04137200,Borner'S Barber College,California,53064,0,0,53064,0
MI,03968300,Lakewood School Of Therapeutic Massage,Michigan,52948,0,0,52948,0
OR,01235100,Phagans' School Of Beauty,Oregon,52869,0,0,52869,0
CA,04173400,Santa Ana Beauty Academy,California,52745,0,0,52745,0
IL,03643300,Mr. John'S School Of Cosmetology & Nails,Illinois,52727,0,0,52727,0
MN,04160500,Avalon School Of Cosmetology,Minnesota,52436,0,0,52436,0
NV,04269800,L Makeup Institute,Nevada,52324,0,0,52324,0
SD,01147700,Sanford Medical Center,South Dakota,13385,13736,25000,52121,0
UT,02572700,Evans Hairstyling College,Utah,52053,0,0,52053,0
GA,04021300,Augusta School Of Massage,Georgia,52041,0,0,52041,0
OK,03676300,Family Of Faith Christian University,Oklahoma,6040,16531,29000,51571,0
OH,04277400,Elite Academy Of Hair Design,Ohio,51496,0,0,51496,0
AR,04274100,Arkansas Welding Academy,Arkansas,51346,0,0,51346,0
ME,03612300,Birthwise Midwifery School,Maine,51189,0,0,51189,0
MI,04231800,Princess Beauty School,Michigan,51144,0,0,51144,0
MI,03090000,Sharp'S Academy Of Hairstyling,Michigan,50808,0,0,50808,0
WI,00941900,State College Of Beauty Culture,Wisconsin,50340,0,0,50340,0
KY,04038700,Ideal Beauty Academy,Kentucky,50189,0,0,50189,0
CA,01179200,Franciscan School Of Theology,California,7856,14789,27000,49645,0
TX,04215000,Total Transformation Institute Of Cosmetology,Texas,49523,0,0,49523,0
LA,03027300,Blalock'S Professional Beauty College,Louisiana,48933,0,0,48933,0
FL,04276500,Global Medical & Technical Training Institute,Florida,48533,0,0,48533,0
IN,03538300,Alexandria School Of Scientific Therapeutics,Indiana,48376,0,0,48376,0
LA,04248900,Vh Barber & Styling Academy,Louisiana,48247,0,0,48247,0
CO,04202600,New Dimensions Beauty Academy,Colorado,48218,0,0,48218,0
TX,03111000,Mid Cities Barber College,Texas,48082,0,0,48082,0
CO,04121200,Institute Of Taoist Education And Acupuncture,Colorado,11057,12975,24000,48032,0
WV,04028300,Mountain State School Of Massage,West Virginia,47967,0,0,47967,0
IL,02202600,Cannella School Of Hair Design,Illinois,47966,0,0,47966,0
CT,04148400,Tigi Hairdressing Academy Guilford,Connecticut,47853,0,0,47853,0
NE,03279300,Myotherapy Institute,Nebraska,47524,0,0,47524,0
NH,02245400,Keene Beauty Academy,New Hampshire,47439,0,0,47439,0
SC,04228600,Top Of The Line Barber College,South Carolina,47386,0,0,47386,0
AZ,04148700,American Institute Of Interior Design,Arizona,47278,0,0,47278,0
PA,04215500,Champ'S Barber School,Pennsylvania,47263,0,0,47263,0
TX,04276400,Culinary School Of Fort Worth (The),Texas,47260,0,0,47260,0
TN,03841300,Career Beauty College,Tennessee,47255,0,0,47255,0
CA,04242600,Abco Technology,California,46979,0,0,46979,0
IL,04225300,Creative Touch Cosmetology School,Illinois,46816,0,0,46816,0
VT,04146900,Advanced Welding Institute,Vermont,46587,0,0,46587,0
OH,00966000,Tiffin Academy Of Hair Design,Ohio,46336,0,0,46336,0
IL,02323300,Professionals Choice Hair Design Academy,Illinois,46213,0,0,46213,0
IL,04192000,Curve Metric School Of Hair Design,Illinois,46054,0,0,46054,0
TX,03153300,American College Of Acupuncture & Oriental Medicine,Texas,45939,0,0,45939,0
VA,04214700,Luckes Beauty Academy,Virginia,45259,0,0,45259,0
LA,02338000,Cloyd'S Barber School #2,Louisiana,44745,0,0,44745,0
IL,00893900,Cannella School Of Hair Design,Illinois,44650,0,0,44650,0
MO,03101000,New Dimension School Of Hair Design,Missouri,44577,0,0,44577,0
NC,04129400,Center For Massage & Natural Health,North Carolina,44551,0,0,44551,0
OK,04213600,River Valley Cosmetology Institute,Oklahoma,44407,0,0,44407,0
FL,04182500,Millennia Atlantic University,Florida,44229,0,0,44229,0
TX,03156400,Aoma Graduate School Of Integrative Medicine,Texas,44228,0,0,44228,0
MA,04229200,Jupiter Beauty Academy,Massachusetts,44219,0,0,44219,0
KY,04247700,Regina Webb Academy,Kentucky,44105,0,0,44105,0
TX,00849800,William Edge Institute,Texas,44088,0,0,44088,0
PA,04226300,Divine Crown Barber & Beauty Academy,Pennsylvania,44060,0,0,44060,0
GA,04260000,Institute Of Medical Ultrasound,Georgia,43581,0,0,43581,0
MT,02621300,Academy Of Cosmetology,Montana,43527,0,0,43527,0
OH,04266100,Apex Academy Hair Skin Nails School Of Cosmetology,Ohio,43429,0,0,43429,0
IL,04136900,University Of Aesthetics & Cosmetology,Illinois,43036,0,0,43036,0
CA,04248200,Dehart Technical School,California,42994,0,0,42994,0
IN,04246600,Textures Institute Of Cosmetology,Indiana,42921,0,0,42921,0
AR,03997300,Arkansas Beauty College,Arkansas,42819,0,0,42819,0
AR,04238900,"Beauty School, (The)",Arkansas,42726,0,0,42726,0
PR,03800300,Colegio Técnico De Electricidad Galloza,Puerto Rico,42670,0,0,42670,0
NH,03437300,Upper Valley Educators Institute,New Hampshire,8729,16699,17000,42428,0
PA,04267300,Lehigh Valley Barber School,Pennsylvania,42426,0,0,42426,0
NH,01318900,Continental Academie Of Hair Design,New Hampshire,42043,0,0,42043,0
NJ,04229100,Advantage Career Institute,New Jersey,41609,0,0,41609,0
IL,00456000,Gem City College,Illinois,41594,0,0,41594,0
KY,04239600,Kentucky Horseshoeing School,Kentucky,41510,0,0,41510,0
PA,04236800,Fountain Of Youth Academy Of Cosmetology,Pennsylvania,41507,0,0,41507,0
IL,02332200,Hair Professionals Career College,Illinois,41496,0,0,41496,0
PA,02292700,Lansdale School Of Cosmetology,Pennsylvania,41255,0,0,41255,0
TX,04271700,Salon Professional Academy Of San Antonio (The),Texas,41200,0,0,41200,0
PA,02273400,Reconstructionist Rabbinical College,Pennsylvania,8438,11390,21000,40828,0
PA,01162200,Welder Training & Testing Institute,Pennsylvania,40685,0,0,40685,0
IL,02228100,Steven Papageorge Hair Academy,Illinois,40486,0,0,40486,0
TN,03079100,North Central Institute,Tennessee,40259,0,0,40259,0
VA,00953700,Virginia School Of Hair Design,Virginia,40047,0,0,40047,0
NY,04223300,Alliance Computing Solutions,New York,40031,0,0,40031,0
CA,04253700,Sacramento Ultrasound Institute,California,39829,0,0,39829,0
NY,01167700,Memorial Sloan Kettering Cancer Center,New York,7585,11233,21000,39818,0
OR,04167400,Sage School Of Massage & Esthetics,Oregon,39511,0,0,39511,0
MO,02608000,Neosho Beauty College,Missouri,39487,0,0,39487,0
TX,04236900,K&G 5 Star Barber College,Texas,39446,0,0,39446,0
MI,00894600,Port Huron Cosmetology College,Michigan,39026,0,0,39026,0
MI,04255100,U.S. Truck Driver Training School,Michigan,38918,0,0,38918,0
TX,04274500,Strand Institute Of Beauty & Esthetics (The),Texas,38506,0,0,38506,0
NY,04275100,Anousheh School Of Hair,New York,38286,0,0,38286,0
FL,04263500,American Beauty Schools,Florida,38193,0,0,38193,0
IL,04137000,University Of Aesthetics & Cosmetology (The),Illinois,37971,0,0,37971,0
VA,04275900,Another Level Barbering And Cosmetology School,Virginia,37931,0,0,37931,0
AZ,04268000,Kor Beauty Academy,Arizona,37326,0,0,37326,0
AZ,03617500,Phoenix Institute Of Herbal Medicine & Acupuncture,Arizona,37245,0,0,37245,0
TX,04177900,Buckner Barber School,Texas,37184,0,0,37184,0
FL,04227500,Merryfield School Of Pet Grooming,Florida,37149,0,0,37149,0
TX,02176100,Pipo Academy Of Hair Design,Texas,37076,0,0,37076,0
LA,04268100,Ray J'S College Of Hair,Louisiana,36978,0,0,36978,0
CA,04217400,High Tech High Graduate School Of Education,California,6110,10792,20000,36902,0
AR,03214300,Velvatex College Of Beauty Culture,Arkansas,36831,0,0,36831,0
MD,04168900,Holistic Massage Training Institute,Maryland,36599,0,0,36599,0
ID,04150600,Urban 113 School Of Cosmetology,Idaho,36448,0,0,36448,0
PA,04261300,European Medical School Of Massage,Pennsylvania,36317,0,0,36317,0
PA,03109100,"Workforce Institute'S City College, The",Pennsylvania,17617,18063,0,35680,0
CA,04246200,California Institute Of Medical Science,California,35107,0,0,35107,0
AZ,02113800,Roberto-Venn School Of Luthiery,Arizona,35092,0,0,35092,0
MS,02516200,Wesley Biblical Seminary,Mississippi,4013,11034,20000,35047,0
CA,04234000,San Francisco Film School,California,34950,0,0,34950,0
IN,00163700,Bethany Theological Seminary,Indiana,5547,10344,19000,34891,0
TN,04253100,Allied Health Careers Institute,Tennessee,34679,0,0,34679,0
IA,00959300,La' James International College,Iowa,34528,0,0,34528,0
IN,04232800,John Patrick University Of Health And Applied Sciences,Indiana,34392,0,0,34392,0
MI,04159300,Marketti Academy Of Cosmetology,Michigan,34387,0,0,34387,0
NH,04162200,American Academy Of Health And Beauty,New Hampshire,34010,0,0,34010,0
CO,04093300,Academy Of Natural Therapy,Colorado,33501,0,0,33501,0
UT,04183000,Top Nails & Hair Beauty School,Utah,33446,0,0,33446,0
IA,02274100,La' James International College - Des Moines,Iowa,33414,0,0,33414,0
KY,04240600,Tri-State Barber College,Kentucky,33384,0,0,33384,0
IN,02351300,Knox Beauty College,Indiana,32917,0,0,32917,0
AZ,04177500,Pure Aesthetics Natural Skincare School,Arizona,32907,0,0,32907,0
CO,03686300,Colorado School Of Traditional Chinese Medicine,Colorado,32880,0,0,32880,0
SD,00492900,Avera Mckennan Hospital,South Dakota,6110,9372,17000,32482,0
MA,02137000,Rob Roy Academy,Massachusetts,32113,0,0,32113,0
OK,02556500,Yukon Beauty College,Oklahoma,31965,0,0,31965,0
OH,03051500,Us Grant Joint Vocational School,Ohio,6833,25117,0,31950,0
IL,04167800,Innovations Design Academy,Illinois,31827,0,0,31827,0
AZ,02533200,School Of Architecture At Taliesin (The),Arizona,3492,9577,18000,31069,0
NY,03096200,Charles Stuart School,New York,30844,0,0,30844,0
VA,04156200,Institute Of Advanced Medical Esthetics,Virginia,30626,0,0,30626,0
MO,04247400,Ea La Mar'S Cosmetology & Barber College,Missouri,30499,0,0,30499,0
MO,04249500,Lebanon College Of Cosmetology,Missouri,30034,0,0,30034,0
CA,04236700,Blush School Of Makeup,California,29877,0,0,29877,0
MI,03109700,Cadillac Institute Of Cosmetology,Michigan,29719,0,0,29719,0
NY,03568300,Leon Studio One School Of Beauty Knowledge,New York,29227,0,0,29227,0
WI,04231400,Bella Academy Of Cosmetology,Wisconsin,29101,0,0,29101,0
TX,04267200,Allgood Beauty Institute,Texas,29054,0,0,29054,0
MI,04211200,Brighton Institute Of Cosmetology,Michigan,29053,0,0,29053,0
CO,04080300,Aspen University,Colorado,28984,0,0,28984,0
MA,02339400,Rob Roy Academy,Massachusetts,28869,0,0,28869,0
TN,04223900,Mind Body Institute,Tennessee,28782,0,0,28782,0
VA,02538800,Suffolk Beauty Academy,Virginia,28655,0,0,28655,0
IA,02134500,La' James International College,Iowa,28646,0,0,28646,0
SD,00598700,Avera Sacred Heart Hospital School Of Radiologic Technology,South Dakota,6983,7599,14000,28582,0
VA,00953500,Staunton School Of Cosmetology,Virginia,28378,0,0,28378,0
CO,04139300,National Beauty College,Colorado,28336,0,0,28336,0
TN,04203600,Franklin Hair Academy School Of Cosmetology,Tennessee,28291,0,0,28291,0
AL,03032500,Alabama State College Of Barber Styling,Alabama,28259,0,0,28259,0
MS,04267100,Unlimited Cosmetology School,Mississippi,28162,0,0,28162,0
NH,02247000,New England School Of Hair Design,New Hampshire,27906,0,0,27906,0
ID,04168600,College Of Massage Therapy,Idaho,27849,0,0,27849,0
TN,04258900,Master'S Barber & Styling College,Tennessee,27762,0,0,27762,0
MO,04173900,Evolve Beauty Academy,Missouri,27103,0,0,27103,0
NC,04146400,Daoist Traditions College Of Chinese Medical Arts,North Carolina,27061,0,0,27061,0
WI,04237400,Wright Graduate University For The Realization Of Human Potential,Wisconsin,5238,7786,14000,27024,0
NM,02622000,Southwest Acupuncture College,New Mexico,26770,0,0,26770,0
TN,04246500,Massage Institute Of Memphis (The),Tennessee,26324,0,0,26324,0
SC,02567600,Sumter Beauty College,South Carolina,24772,0,0,24772,0
CT,04224200,Belle Academy Of Cosmetology,Connecticut,24212,0,0,24212,0
WA,03280300,Seattle Institute Of East Asian Medicine,Washington,24151,0,0,24151,0
MA,03859300,Eine Electrology/Esthetics Institute Of Ne,Massachusetts,23996,0,0,23996,0
FL,04252400,Worldclass Academy Of Beauty Careers,Florida,23877,0,0,23877,0
ND,04223500,Lynnes Welding Training,North Dakota,23803,0,0,23803,0
IA,03720300,Carlson College Of Massage Therapy,Iowa,23609,0,0,23609,0
CA,02520200,California Career School,California,23569,0,0,23569,0
MA,02274300,Conway School Of Landscape Design,Massachusetts,6692,5869,11000,23561,0
VA,02111600,Sovah School Of Health Professions,Virginia,23286,0,0,23286,0
CA,00112000,American Baptist Seminary Of The West,California,9311,13958,0,23269,0
NJ,04216500,Rizzieri Institute,New Jersey,23111,0,0,23111,0
LA,04246700,Learning Bridge Career Institute,Louisiana,22916,0,0,22916,0
IA,01300600,La'James International College,Iowa,22241,0,0,22241,0
FL,04249400,Center For Neurosomatic Studies,Florida,21825,0,0,21825,0
MN,03833300,American Academy Of Traditional Chinese Medicine,Minnesota,21532,0,0,21532,0
PR,03638300,Rosslyn Training Academy Of Cosmetology,Puerto Rico,21345,0,0,21345,0
PA,00337500,Theological Seminary Reformed Episcopal Church,Pennsylvania,4074,6200,11000,21274,0
TX,04248000,"Recording Conservatory Of Austin, (The)",Texas,20622,0,0,20622,0
CA,04185500,Beverly Hills Design Institute,California,20598,0,0,20598,0
PA,00335800,Reformed Presbyterian Theological Seminary,Pennsylvania,20401,0,0,20401,0
NJ,03811300,Eastern School Of Acupuncture And Traditional Medicine,New Jersey,19495,0,0,19495,0
MA,02337400,Bancroft School Of Massage Therapy,Massachusetts,19166,0,0,19166,0
CA,02120600,Saybrook University,California,3469,5623,10000,19092,0
IL,01069500,Tri County Beauty Academy,Illinois,18823,0,0,18823,0
OH,02239800,Pioneer Career And Technology Center: A Vocational School District,Ohio,2969,5671,10000,18640,0
PA,04118000,Byzantine Catholic Seminary Of Saints Cyril And Methodius,Pennsylvania,3022,5585,10000,18607,0
VA,03966300,Virginia Beach Theological Seminary,Virginia,3070,5421,10000,18491,0
TX,03110800,Bakke Graduate University,Texas,2662,5600,10000,18262,0
IN,01015100,Vincennes Beauty College,Indiana,18044,0,0,18044,0
NY,03433500,Lia Schorr Institute Of Cosmetic Skin Care Training,New York,16952,0,0,16952,0
NY,04273200,Berkowits School Of Electrolysis,New York,16632,0,0,16632,0
TX,04219700,Gemini School Of Visual Arts & Communication,Texas,16326,0,0,16326,0
CA,02267600,Sofia University,California,16303,0,0,16303,0
NH,03729300,New Hampshire Institute For Therapeutic Arts,New Hampshire,16274,0,0,16274,0
IA,00842400,La' James International College,Iowa,15386,0,0,15386,0
FL,04276800,Kck Beauty & Barber Academy,Florida,15023,0,0,15023,0
NJ,04234400,American Institute Of Alternative Medicine,New Jersey,14814,0,0,14814,0
HI,03735300,Institute Of Clinical Acupuncture And Oriental Medicine,Hawaii,14549,0,0,14549,0
CO,04125100,Montessori Casa International,Colorado,3492,4016,7000,14508,0
IN,04258200,Christina And Company Education Center,Indiana,14023,0,0,14023,0
WI,04219300,East-West Healing Arts Institute,Wisconsin,13994,0,0,13994,0
FL,04162000,Jose Maria Vargas University,Florida,13814,0,0,13814,0
CA,04271100,Meridian University,California,13758,0,0,13758,0
NY,03665400,Christie'S Education,New York,13385,0,0,13385,0
CA,04005300,United States University,California,12982,0,0,12982,0
FL,04233200,Unilatina International College,Florida,11930,0,0,11930,0
AR,04241900,River Valley School Of Massage,Arkansas,11895,0,0,11895,0
ID,04207200,Academy Di Firenze,Idaho,9836,0,0,9836,0
CA,04248300,Los Angeles Academy Of Figurative Art,California,9263,0,0,9263,0
FL,04274200,Installer Institute,Florida,8619,0,0,8619,0
CA,04194600,Brand College,California,8147,0,0,8147,0
UT,04216800,Bonnie Joseph Academy Of Cosmetology & Barbering,Utah,7948,0,0,7948,0
AZ,03695500,Arizona School Of Acupuncture And Oriental Medicine,Arizona,7856,0,0,7856,0
MI,04275200,Dsdt,Michigan,7856,0,0,7856,0
NY,03169300,Studio Jewelers,New York,7528,0,0,7528,0
CA,04192500,Westchester College Of Nursing & Allied Health,California,6110,0,0,6110,0
HI,04165200,Mauna Loa Helicopters,Hawaii,6110,0,0,6110,0
FL,04254300,Pets Playground Grooming School,Florida,5656,0,0,5656,0
TX,04272600,Vogue International Academy,Texas,5534,0,0,5534,0
IA,00765800,American College Of Hairstyling-Des Moines,Iowa,5528,0,0,5528,0
NJ,04257800,Mobile Technical Training,New Jersey,5238,0,0,5238,0
NC,03237300,Anson College Of Cosmetology,North Carolina,3468,0,0,3468,0
VA,04110300,University Of Management And Technology (The),Virginia,2694,0,0,2694,0
CA,00188100,Ashford University,California,1001,0,0,1001,0
PA,04124600,Professional Academy Of Cosmetology,Pennsylvania,873,0,0,873,0
NV,03975300,Institute Of Professional Careers,Nevada,291,0,0,291,0
